000000000000000
000050000050000
000500050005000
005000000000500
050000000000050
000000050000000
000000000000000
005005050500500
000000000000000
000000050000000
050000000000050
005000000000500
000500050005000
000050000050000
000000000000000
