10 10
0 0 0 0 0 0 0 0 0 0
0 0 1 1 0 0 1 1 0 0
0 0 1 0 0 0 0 1 0 0
0 0 1 0 0 0 0 1 0 0
0 0 0 0 1 1 0 0 0 0
0 0 0 0 1 1 0 0 0 0
0 0 1 0 0 0 0 1 0 0
0 0 1 0 0 0 0 1 0 0
0 0 1 1 0 0 1 1 0 0
0 0 0 0 0 0 0 0 0 0
2 5 6 1 2 2
2 5 5 9 2 2
