0000000000
0011001100
0010000100
0010000100
0000110000
0000110000
0010000100
0010000100
0011001100
0000000000
