00100100100
00100100100
00000000000
00000000000
00000000000
11100100111
00000000000
00000000000
00000000000
00100100100
00100100100
