000000000000000
000010000010000
000100010001000
001000000000100
010000000000010
000000010000000
000000000000000
001001010100100
000000000000000
000000010000000
010000000000010
001000000000100
000100010001000
000010000010000
000000000000000
