20 20
2 2 2 2 0 1 1 1 1 0 0 0 0 0 0 0 0 0 0 0
2 2 2 0 0 1 0 0 0 0 0 0 0 0 0 0 0 0 0 0
2 2 2 0 0 1 0 0 0 0 0 0 0 0 0 0 0 0 0 0
2 0 0 0 0 1 0 0 0 0 0 0 0 0 0 0 0 0 0 0
0 0 0 0 0 0 0 0 0 0 0 0 0 0 0 0 0 0 0 0
0 0 0 0 0 0 0 0 0 0 0 0 0 0 0 0 1 1 1 1
0 0 0 0 0 0 0 1 0 0 0 1 0 0 0 0 0 0 0 1
0 0 0 0 0 0 0 1 0 0 0 1 0 0 0 0 0 0 0 1
0 0 0 0 0 1 1 1 0 2 0 1 1 1 0 0 0 0 0 1
0 0 0 0 0 0 0 0 2 2 2 0 0 0 0 0 0 0 0 0
0 0 0 0 0 1 1 1 0 2 0 1 1 1 0 0 0 0 0 0
1 0 0 0 0 0 0 1 0 0 0 1 0 0 0 0 0 0 0 0
1 0 0 0 0 0 0 1 0 0 0 1 0 0 0 0 0 0 0 0
1 0 0 0 0 0 0 0 0 0 0 0 0 0 0 0 0 0 0 0
1 1 1 1 0 0 0 0 0 0 0 0 0 0 0 0 0 0 0 0
0 0 0 0 0 0 0 0 0 0 0 0 0 0 0 0 0 0 0 0
0 0 0 0 0 0 0 0 0 0 0 0 0 0 1 0 0 0 0 2
0 0 0 0 0 0 0 0 0 0 0 0 0 0 1 0 0 2 2 2
0 0 0 0 0 0 0 0 0 0 0 0 0 0 1 0 0 2 2 2
0 0 0 0 0 0 0 0 0 0 0 1 1 1 1 0 2 2 2 2
2 1 18 2 2 2
2 2 2 18 2 2
2 5 8 2 2 2
2 5 7 16 2 2
2 5 13 4 2 2
2 5 12 18 2 2
2 6 2 10 2 2
2 6 18 9 2 2
2 12 11 0 1 1
2 16 12 0 1 1
2 17 13 0 1 1
2 19 14 0 1 1
2 13 14 1 1 1
2 14 14 2 1 1
2 10 14 3 1 1
2 9 10 5 1 1
2 15 10 6 1 1
2 22 10 7 1 1
2 16 11 7 1 1
2 11 12 7 1 1
2 9 8 5 1 1
2 15 8 6 1 1
2 20 8 7 1 1
2 18 7 7 1 1
2 12 6 7 1 1
2 11 3 5 1 1
2 18 2 5 1 1
2 17 1 5 1 1
2 21 0 5 1 1
2 14 0 6 1 1
2 15 0 7 1 1
2 10 0 8 1 1
2 9 19 11 1 1
2 13 19 12 1 1
2 15 19 13 1 1
2 20 19 14 1 1
2 16 18 14 1 1
2 18 17 14 1 1
2 12 16 14 1 1
2 11 12 11 1 1
2 17 11 11 1 1
2 21 10 11 1 1
2 14 10 12 1 1
2 10 10 13 1 1
2 12 6 11 1 1
2 17 7 11 1 1
2 19 8 11 1 1
2 15 8 12 1 1
2 10 8 13 1 1
2 9 5 16 1 1
2 13 5 17 1 1
2 14 5 18 1 1
2 22 5 19 1 1
2 16 6 19 1 1
2 17 7 19 1 1
2 11 8 19 1 1

