40 40
5 5 5 7 2 1 1 1 1 3 3 3 0 0 0 0 0 0 2 1 1 1 1 2 0 0 0 0 0 0 0 0 0 0 0 0 3 3 3 3
5 5 7 7 2 1 2 2 3 3 3 3 0 0 0 0 0 0 2 2 2 2 2 2 0 0 0 0 0 0 0 0 0 0 0 0 3 3 3 3
5 7 7 0 2 1 2 0 3 3 3 3 0 0 0 0 0 0 0 0 0 0 0 0 0 0 0 0 0 0 0 0 0 0 0 0 3 3 3 3
7 7 0 0 2 1 2 0 3 3 3 3 0 0 0 0 0 0 0 0 0 0 0 0 0 0 0 0 0 0 0 0 0 0 0 0 3 3 3 3
0 0 0 0 2 2 2 0 0 0 0 0 0 0 0 2 2 2 2 2 2 3 3 3 3 0 0 0 0 0 0 0 0 0 0 2 2 2 2 0
0 0 0 0 0 0 2 2 2 0 2 2 2 0 3 3 1 1 1 1 2 3 3 3 3 0 0 0 0 0 0 0 0 0 0 2 1 1 2 0
3 3 3 3 0 0 2 1 6 6 6 1 2 0 3 3 3 3 2 1 2 3 3 3 3 0 0 0 0 0 0 0 0 0 0 2 1 2 2 0
3 3 3 3 2 2 2 1 6 4 6 1 2 2 3 3 3 3 2 1 2 3 3 3 3 0 0 0 2 2 2 0 0 0 0 2 2 2 7 7
3 3 3 3 2 1 1 1 4 4 4 1 1 1 3 3 3 3 2 1 2 0 0 0 0 0 0 0 2 1 2 0 0 0 0 0 0 0 7 5
3 3 3 3 2 2 6 4 4 4 4 4 6 2 2 0 0 0 2 1 2 0 0 0 0 0 2 2 2 1 2 2 2 0 0 0 0 0 7 5
2 2 0 0 2 1 1 1 4 4 4 1 1 1 2 0 0 0 2 1 2 0 0 0 0 0 2 1 1 1 1 1 2 0 0 0 0 0 7 5
1 2 0 0 2 2 2 1 4 4 4 1 2 2 2 0 0 0 2 1 2 0 0 0 0 0 2 2 2 2 2 2 2 0 0 0 0 0 7 5
1 2 0 0 0 0 2 1 6 4 6 1 2 0 0 0 0 0 2 2 2 0 0 0 0 0 0 0 0 0 0 0 0 0 2 2 2 0 7 7
1 2 2 2 2 0 2 2 6 6 6 2 2 0 0 0 0 0 0 0 0 0 0 0 0 0 0 0 3 3 3 3 0 0 2 1 2 0 0 0
1 1 1 1 2 0 0 0 0 0 0 0 0 0 0 0 0 0 0 0 0 0 0 0 0 0 0 0 3 3 3 3 0 0 2 1 2 0 0 0
2 2 2 2 2 0 0 0 0 0 0 0 0 2 2 2 0 0 0 0 0 0 0 0 0 0 0 0 3 3 3 3 0 0 2 1 2 0 0 0
0 0 0 0 0 0 0 3 3 3 3 0 0 2 1 2 0 0 7 7 7 2 0 2 2 2 0 0 3 3 3 3 0 0 2 1 2 0 0 0
0 0 0 0 0 0 0 3 3 3 3 0 0 2 1 2 0 7 7 5 1 2 0 2 1 2 0 0 0 0 0 0 0 0 2 2 2 0 0 0
0 0 0 0 0 0 0 3 3 3 3 2 2 2 1 2 7 7 5 5 1 2 0 2 1 6 6 0 0 0 0 0 0 0 0 0 0 0 0 0
0 0 0 0 0 0 0 3 3 3 3 1 1 1 1 2 7 5 5 5 1 2 0 2 1 4 6 6 0 0 0 0 0 0 0 0 0 0 0 0
0 0 0 0 0 0 0 0 0 0 2 2 2 2 2 2 7 1 1 1 1 2 0 2 1 4 4 6 2 2 0 0 0 0 0 0 0 0 0 0
0 2 2 2 0 0 0 0 0 0 0 0 0 0 0 0 3 3 3 3 1 2 0 2 1 1 1 1 1 2 0 0 0 0 2 2 2 0 0 0
0 2 1 2 0 0 0 0 0 0 0 0 0 0 0 0 3 3 3 3 1 2 0 2 1 3 3 3 3 2 0 0 0 0 2 1 2 0 0 0
0 2 1 2 0 7 7 7 2 0 0 0 0 0 0 0 3 3 3 3 1 2 0 2 1 3 3 3 3 0 0 0 2 2 2 1 2 0 0 0
0 2 1 2 0 7 5 1 2 0 0 0 0 0 0 0 3 3 3 3 2 2 0 2 1 3 3 3 3 0 0 0 2 1 1 1 2 0 0 0
0 2 1 2 0 7 5 1 2 0 0 0 0 0 0 0 0 0 0 0 0 0 0 2 1 3 3 3 3 2 0 0 7 5 5 1 2 0 0 0
0 2 1 2 0 7 5 1 2 0 0 3 3 3 3 0 0 0 0 0 0 0 0 2 2 2 0 2 1 2 0 0 7 7 5 1 2 0 0 0
0 2 1 2 0 7 5 1 2 0 0 3 3 3 3 0 0 0 2 2 2 0 0 0 0 0 0 2 1 2 0 0 0 7 7 2 2 0 0 0
0 2 1 2 0 7 5 1 2 0 0 3 3 3 3 0 0 0 2 1 2 0 0 0 0 0 0 2 1 2 0 0 0 0 0 0 0 0 0 0
0 2 1 2 0 7 5 1 2 2 2 3 3 3 3 0 0 0 2 1 2 0 0 0 0 0 0 2 2 2 0 0 0 0 0 0 0 0 0 0
0 2 1 2 0 7 5 1 1 1 1 1 1 2 0 0 0 0 2 2 2 0 0 0 2 2 2 2 2 2 0 0 0 0 3 3 3 3 0 0
0 2 1 2 0 7 7 7 2 2 2 2 2 2 0 0 0 0 0 0 0 0 0 0 2 1 1 1 1 2 0 0 0 0 3 3 3 3 0 0
0 2 1 2 2 2 0 0 0 0 0 0 0 0 0 0 0 0 0 0 0 0 0 3 3 3 3 2 1 2 0 0 0 0 3 3 3 3 0 0
0 2 1 1 1 2 0 0 0 0 0 0 0 0 0 0 0 0 0 0 0 0 0 3 3 3 3 2 1 2 0 0 0 0 3 3 3 3 0 0
0 2 2 2 1 2 3 3 3 3 0 0 0 0 0 0 0 0 0 0 0 0 0 3 3 3 3 2 1 2 0 0 0 0 0 0 0 0 0 0
0 0 0 2 1 2 3 3 3 3 0 0 0 0 0 0 0 0 0 0 0 0 0 3 3 3 3 2 2 2 0 0 2 2 2 0 0 0 0 0
6 6 0 2 1 2 3 3 3 3 0 0 0 0 0 0 0 0 0 0 0 0 0 0 0 0 0 0 0 0 0 2 2 1 2 0 0 0 7 7
4 6 6 2 2 2 3 3 3 3 0 0 0 2 2 2 2 2 2 2 2 0 0 0 0 0 0 0 0 0 0 2 1 1 2 0 0 7 7 5
4 4 6 6 0 0 0 0 0 0 0 0 0 2 1 1 1 1 1 1 2 0 0 0 0 0 0 0 0 0 0 2 2 2 2 0 7 7 5 5
4 4 4 6 0 0 0 0 0 0 0 0 0 2 2 2 2 2 2 2 2 0 0 0 0 0 0 0 0 0 0 0 0 0 0 0 7 5 5 5
# BASES
2 1000 34 18 3 3
2 1001 4 30 3 3
# ENERGY GEN
2 2000 2 38 2 2
2 2000 8 2 2 2
2 2000 7 16 2 2
2 2000 15 30 2 2
2 2000 23 18 2 2
2 2000 34 25 2 2
2 2000 36 8 2 2
# MATERIAL GEN
2 2001 2 10 2 2
2 2001 6 23 2 2
2 2001 18 9 2 2
2 2001 24 27 2 2
2 2001 28 13 2 2
2 2001 32 36 2 2
## MOUNTAINS
2 4003 11 0 1 1
2 4007 12 0 1 1
2 4008 13 0 1 1
2 4010 14 0 1 1
2 4004 14 1 1 1
2 4005 14 2 1 1
2 4001 14 3 1 1
2 4000 10 5 1 1
2 4006 10 6 1 1
2 4013 10 7 1 1
2 4007 11 7 1 1
2 4002 12 7 1 1
2 4000 8 5 1 1
2 4006 8 6 1 1
2 4011 8 7 1 1
2 4009 7 7 1 1
2 4003 6 7 1 1
2 4002 3 5 1 1
2 4009 2 5 1 1
2 4008 1 5 1 1
2 4012 0 5 1 1
2 4005 0 6 1 1
2 4006 0 7 1 1
2 4001 0 8 1 1
2 4000 19 11 1 1
2 4004 19 12 1 1
2 4005 19 13 1 1
2 4011 19 14 1 1
2 4007 18 14 1 1
2 4009 17 14 1 1
2 4003 16 14 1 1
2 4002 12 11 1 1
2 4008 11 11 1 1
2 4012 10 11 1 1
2 4005 10 12 1 1
2 4001 10 13 1 1
2 4003 6 11 1 1
2 4008 7 11 1 1
2 4010 8 11 1 1
2 4006 8 12 1 1
2 4001 8 13 1 1
2 4000 5 16 1 1
2 4004 5 17 1 1
2 4005 5 18 1 1
2 4013 5 19 1 1
2 4007 6 19 1 1
2 4008 7 19 1 1
2 4009 8 19 1 1
2 4007 9 19 1 1
2 4008 10 19 1 1
2 4002 11 19 1 1
# top central
2 4000 0 19 1 1
2 4006 0 20 1 1
2 4005 0 21 1 1
2 4001 0 22 1 1
# top-right horizontal 
2 4003 08 29 1 1
2 4007 09 29 1 1
2 4000 10 27 1 1
2 4004 10 28 1 1
2 4014 10 29 1 1
2 4006 10 30 1 1
2 4001 10 31 1 1
# central-left T
2 4003 17 20 1 1
2 4007 18 20 1 1
2 4008 19 20 1 1
2 4016 20 20 1 1
2 4009 21 20 1 1
2 4008 22 20 1 1
2 4002 23 20 1 1
2 4000 20 17 1 1
2 4004 20 18 1 1
2 4005 20 19 1 1
# central-right T
2 4003 17 24 1 1
2 4007 18 24 1 1
2 4008 19 24 1 1
2 4008 20 24 1 1
2 4017 21 24 1 1
2 4009 22 24 1 1
2 4008 23 24 1 1
2 4007 24 24 1 1
2 4002 25 24 1 1
2 4004 21 25 1 1
2 4005 21 26 1 1
2 4006 21 27 1 1
2 4001 21 28 1 1
# small vertical bottom-right
2 4003 26 28 1 1
2 4007 27 28 1 1
2 4002 28 28 1 1
# bottom central L
2 4000 31 25 1 1
2 4006 31 26 1 1
2 4004 31 27 1 1
2 4013 31 28 1 1
2 4007 32 28 1 1
2 4008 33 28 1 1
2 4002 34 28 1 1
# bottom right T
2 4000 24 33 1 1
2 4004 24 34 1 1
2 4003 22 35 1 1
2 4007 23 35 1 1
2 4016 24 35 1 1
2 4008 25 35 1 1
2 4002 26 35 1 1
# big L on bottom left
2 4003 24 7 1 1
2 4007 25 7 1 1
2 4009 26 7 1 1
2 4008 27 7 1 1
2 4009 28 7 1 1
2 4007 29 7 1 1
2 4010 30 7 1 1
2 4004 30 8 1 1
2 4005 30 9 1 1
2 4006 30 10 1 1
2 4004 30 11 1 1
2 4001 30 12 1 1
# small vertical central-bottom
2 4003 28 19 1 1
2 4002 29 19 1 1
# bottom left long vertical
2 4003 22 2 1 1
2 4009 23 2 1 1
2 4008 24 2 1 1
2 4007 25 2 1 1
2 4009 26 2 1 1
2 4009 27 2 1 1
2 4007 28 2 1 1
2 4008 29 2 1 1
2 4009 30 2 1 1
2 4008 31 2 1 1
2 4007 32 2 1 1
2 4010 33 2 1 1
2 4004 33 3 1 1
2 4013 33 4 1 1
2 4009 34 4 1 1
2 4007 35 4 1 1
2 4002 36 4 1 1
# central top-right
2 4003 13 35 1 1
2 4008 14 35 1 1
2 4007 15 35 1 1
2 4002 16 35 1 1
# top right small corner
2 4012 5 36 1 1
2 4001 5 37 1 1
2 4002 6 36 1 1
# center bottom horizontal
2 4000 38 14 1 1
2 4006 38 15 1 1
2 4005 38 16 1 1
2 4004 38 17 1 1
2 4006 38 18 1 1
2 4001 38 19 1 1
# bottom right small corner
2 4003 36 33 1 1
2 4011 37 33 1 1
2 4000 37 32 1 1
# practice target
2 4019 28 22 1 1
2 4019 24 22 1 1
2 4019 24 18 1 1
2 4019 28 17 1 1
