60 60
5 5 5 7 2 1 1 1 1 3 3 3 0 0 0 0 0 0 2 1 1 1 1 2 0 0 0 0 0 0 0 0 0 0 0 3 3 3 3 0 0 0 0 0 2 1 2 0 0 0 0 0 0 0 0 0 0 0 0 0
5 5 7 7 2 1 2 2 3 3 3 3 0 0 0 0 0 0 2 2 2 2 2 2 0 0 0 0 0 0 0 0 0 0 0 3 3 3 3 0 0 0 0 0 2 1 2 0 0 0 0 0 0 0 0 0 0 0 0 0
5 7 7 0 2 1 2 0 3 3 3 3 0 0 0 0 0 0 0 0 0 0 0 0 0 0 0 0 0 0 0 0 0 0 0 3 3 3 3 0 0 0 0 0 2 2 2 0 0 0 0 0 0 0 0 0 0 0 0 0
7 7 0 0 2 1 2 0 3 3 3 3 0 0 0 0 0 0 0 0 0 0 0 0 0 0 0 0 0 0 0 0 0 0 0 3 3 3 3 0 0 0 0 0 0 0 0 0 0 0 0 0 0 0 0 0 0 0 0 0
0 0 0 0 2 2 2 0 0 0 0 0 0 0 0 2 2 2 2 2 2 3 3 3 3 0 0 0 0 0 0 0 0 0 0 2 2 2 2 0 0 0 0 0 0 0 0 0 0 0 0 0 0 0 0 0 0 0 0 0
0 0 0 0 0 0 2 2 2 0 2 2 2 0 3 3 1 1 1 1 2 3 3 3 3 0 0 0 0 0 0 0 0 0 0 2 1 1 2 0 0 0 0 0 3 3 3 3 0 0 0 0 0 0 0 0 0 0 0 0
3 3 3 3 0 0 2 1 2 0 2 1 2 0 3 3 3 3 2 1 2 3 3 3 3 0 0 0 0 0 0 0 0 0 0 2 1 2 2 2 2 2 0 0 3 3 3 3 0 0 0 0 0 0 0 0 0 0 0 0
3 3 3 3 2 2 2 1 6 6 6 1 2 2 3 3 3 3 2 1 2 3 3 3 3 0 0 0 2 2 2 0 0 0 0 2 2 2 7 7 1 2 0 0 3 3 3 3 0 0 0 0 0 0 0 0 0 0 0 0
3 3 3 3 2 1 1 1 6 4 6 1 1 1 3 3 3 3 2 1 2 0 0 0 0 0 0 0 2 1 2 0 0 0 0 0 0 0 7 5 1 2 0 0 3 3 3 3 0 2 2 2 0 0 0 0 0 0 0 0
3 3 3 3 2 2 2 6 4 4 4 6 2 2 2 0 0 0 2 1 2 0 0 0 0 0 2 2 2 1 2 2 2 0 0 0 0 0 7 5 1 2 0 0 0 0 0 0 0 2 1 2 0 0 0 3 3 3 3 0
2 2 0 0 2 1 1 1 6 4 6 1 1 1 2 0 0 0 2 1 2 0 0 0 0 0 2 1 1 1 1 1 2 0 0 0 0 0 7 5 1 2 0 0 0 0 0 0 0 2 1 2 0 0 0 3 3 3 3 0
1 2 0 0 2 2 2 1 6 6 6 1 2 2 2 0 0 0 2 1 2 0 0 0 0 0 2 2 2 2 2 2 2 0 0 0 0 0 7 5 1 2 3 3 3 3 0 0 2 2 1 2 0 0 0 3 3 3 3 0
1 2 0 0 0 0 2 1 2 0 2 1 2 0 0 0 0 0 2 2 2 0 0 0 0 0 0 0 0 0 0 0 0 0 2 2 2 0 7 7 1 2 3 3 3 3 0 0 2 1 1 2 0 0 0 3 3 3 3 0
1 2 2 2 2 0 2 2 2 0 2 2 2 0 0 0 0 0 0 0 0 0 0 0 0 0 0 0 3 3 3 3 0 0 2 1 2 0 0 2 2 2 3 3 3 3 0 0 2 2 2 2 0 0 0 0 0 0 0 0
1 1 1 1 2 0 0 0 0 0 0 0 0 0 0 0 0 0 0 0 0 0 0 0 0 0 0 0 3 3 3 3 0 0 2 1 2 0 0 0 0 0 3 3 3 3 0 0 0 0 0 0 0 0 0 0 0 0 0 0
2 2 2 2 2 0 0 0 0 0 0 0 0 2 2 2 0 0 0 0 0 0 0 0 0 0 0 0 3 3 3 3 0 0 2 1 2 0 0 0 0 0 0 0 0 0 0 0 0 0 0 0 0 0 0 0 0 0 0 0
0 0 0 0 0 0 0 3 3 3 3 0 0 2 1 2 0 0 7 7 7 2 0 2 2 2 0 0 3 3 3 3 0 0 2 1 2 0 0 0 0 0 0 0 0 0 0 0 3 3 3 3 0 0 0 0 0 0 6 6
0 0 0 0 0 0 0 3 3 3 3 0 0 2 1 2 0 7 7 5 1 2 0 2 1 2 0 0 0 0 0 0 0 0 2 2 2 0 0 0 0 0 0 0 0 0 0 0 3 3 3 3 0 0 0 0 0 0 6 4
0 0 0 0 0 0 0 3 3 3 3 2 2 2 1 2 7 7 5 5 1 2 0 2 1 6 6 0 0 0 0 0 0 0 0 0 0 0 0 0 0 0 0 0 0 0 0 0 3 3 3 3 0 0 0 0 0 0 6 4
0 0 0 0 0 0 0 3 3 3 3 1 1 1 1 2 7 5 5 5 1 2 0 2 1 4 6 6 0 0 0 0 0 0 0 0 0 0 0 0 0 0 0 0 0 0 0 0 3 3 3 3 0 0 0 0 0 0 6 4
0 0 0 0 0 0 0 0 0 0 2 2 2 2 2 2 7 1 1 1 1 2 0 2 1 4 4 6 2 2 0 0 0 0 0 0 0 0 0 0 0 0 0 0 0 0 0 0 0 0 0 0 0 0 0 0 0 0 6 6
0 2 2 2 0 0 0 0 0 0 0 0 0 0 0 0 3 3 3 3 1 2 0 2 1 1 1 1 1 2 0 0 0 0 2 2 2 0 0 0 0 0 0 2 2 2 0 0 0 0 0 0 0 0 0 0 0 0 0 0
0 2 1 2 0 0 0 0 0 0 0 0 0 0 0 0 3 3 3 3 1 2 0 2 1 3 3 3 3 2 0 0 0 0 2 1 2 0 0 0 0 0 0 2 1 2 0 0 0 0 0 0 0 0 0 0 0 0 0 0
0 2 1 2 0 7 7 7 2 0 0 0 0 0 0 0 3 3 3 3 1 2 0 2 1 3 3 3 3 0 0 0 2 2 2 1 2 0 0 0 0 0 0 2 1 2 2 2 2 2 0 0 0 0 0 0 0 0 0 0
0 2 1 2 0 7 5 1 2 0 0 0 0 0 0 0 3 3 3 3 2 2 0 2 1 3 3 3 3 0 0 0 2 1 1 1 2 0 0 0 0 0 0 2 1 1 1 1 1 2 0 0 0 0 0 0 0 0 0 0
0 2 1 2 0 7 5 1 2 0 0 0 0 0 0 0 0 0 0 0 0 0 0 2 1 3 3 3 3 2 0 0 7 5 5 1 2 0 0 0 0 0 0 2 2 2 2 2 1 2 2 2 2 2 2 2 2 2 0 0
0 2 1 2 0 7 5 1 2 0 0 3 3 3 3 0 0 0 0 0 0 0 0 2 2 2 0 2 1 2 0 0 7 7 5 1 2 0 0 0 0 0 0 0 0 0 0 2 1 1 1 1 1 1 1 1 1 2 0 0
0 2 1 2 0 7 5 1 2 0 0 3 3 3 3 0 0 0 2 2 2 0 0 0 0 0 0 2 1 2 0 0 0 7 7 2 2 0 0 0 0 0 0 0 0 0 0 2 2 2 2 2 2 2 2 2 2 2 0 0
0 2 1 2 0 7 5 1 2 0 0 3 3 3 3 0 0 0 2 1 2 0 0 0 0 0 0 2 1 2 0 0 0 0 0 0 0 0 0 0 2 2 2 0 0 0 0 0 0 0 0 0 0 0 0 0 0 0 0 0
0 2 1 2 0 7 5 1 2 2 2 3 3 3 3 0 0 0 2 1 2 0 0 0 0 0 0 2 2 2 0 0 0 0 0 0 0 0 0 0 2 1 2 0 0 0 0 0 0 0 0 0 0 0 0 0 0 0 0 0
0 2 1 2 0 7 5 1 1 1 1 1 1 2 0 0 0 0 2 2 2 0 0 0 2 2 2 2 2 2 0 0 0 0 3 3 3 3 0 0 2 1 2 0 0 0 0 0 0 0 0 0 0 0 3 3 3 3 0 0
0 2 1 2 0 7 7 7 2 2 2 2 2 2 0 0 0 0 0 0 0 0 0 0 2 1 1 1 1 2 0 0 0 0 3 3 3 3 0 0 2 1 2 0 0 0 0 0 0 0 0 0 0 0 3 3 3 3 0 0
0 2 1 2 2 2 0 0 0 0 0 0 0 0 0 0 0 0 0 0 0 0 0 3 3 3 3 2 1 2 0 0 0 0 3 3 3 3 0 0 2 1 2 0 0 0 0 0 0 0 0 0 0 0 3 3 3 3 0 0
0 2 1 1 1 2 0 0 0 0 0 0 0 0 0 0 0 0 0 0 0 0 0 3 3 3 3 2 1 2 0 0 0 0 3 3 3 3 0 0 2 1 2 0 0 0 0 0 0 2 2 2 0 0 3 3 3 3 0 0
0 2 2 2 1 2 0 0 0 0 0 0 0 0 0 0 0 0 0 0 0 0 0 3 3 3 3 2 1 2 0 0 0 0 0 0 0 0 0 0 2 2 2 0 0 0 0 7 7 2 1 2 0 0 0 0 0 0 0 0
0 0 0 2 1 2 0 3 3 3 3 0 0 0 0 0 0 0 0 0 0 0 0 3 3 3 3 2 2 2 0 0 2 2 2 0 0 0 0 0 0 0 0 0 0 0 7 7 5 2 1 2 0 0 0 0 0 0 0 0
0 0 0 2 1 2 0 3 3 3 3 0 0 0 0 0 0 0 0 0 0 0 0 0 0 0 0 0 0 0 0 2 2 1 2 0 0 0 0 0 0 0 0 0 0 0 7 5 5 2 1 2 0 0 0 0 0 0 0 0
0 0 0 2 2 2 0 3 3 3 3 0 0 2 2 2 2 2 2 2 2 0 0 0 0 0 0 0 0 0 0 2 1 1 2 0 0 0 0 0 0 0 0 0 0 0 2 2 2 2 1 2 2 2 2 0 0 0 0 0
0 0 0 0 0 0 0 3 3 3 3 0 0 2 1 1 1 1 1 1 2 0 0 0 0 0 0 0 0 0 0 2 2 2 2 0 0 0 0 0 0 0 0 0 0 0 2 1 1 1 1 1 1 1 2 0 0 0 0 0
0 0 0 0 0 0 0 0 0 0 0 0 0 2 2 2 2 2 2 2 2 0 0 0 0 0 0 0 0 0 0 0 3 3 3 3 0 0 0 0 0 0 0 0 0 0 2 2 2 2 1 2 2 2 2 0 0 0 0 0
0 0 0 0 0 0 0 0 0 0 0 0 0 0 0 0 0 0 0 0 0 0 0 0 0 0 0 0 0 0 0 0 3 3 3 3 0 0 0 0 0 0 0 0 0 0 0 0 0 2 1 2 0 0 0 0 0 0 0 0
0 0 0 0 0 0 0 0 0 0 0 0 0 0 0 0 0 3 3 3 3 0 0 0 0 0 0 0 0 0 0 0 3 3 3 3 0 0 2 2 2 2 0 0 0 0 0 0 0 2 1 2 0 0 0 0 0 0 0 0
0 0 0 0 0 7 7 7 7 2 0 0 0 0 0 0 0 3 3 3 3 0 0 0 0 0 0 0 0 0 0 0 3 3 3 3 0 0 2 1 1 2 0 0 0 0 0 0 0 2 1 2 0 0 0 0 0 0 0 0
0 0 0 0 0 7 5 5 1 2 0 0 0 0 0 0 0 3 3 3 3 0 0 0 0 0 0 0 0 0 0 0 0 0 0 0 0 0 2 2 1 2 0 0 0 0 0 0 0 2 2 2 0 0 0 0 0 0 0 0
0 0 0 0 0 7 5 5 1 2 0 0 0 0 0 0 0 3 3 3 3 0 0 0 0 0 0 0 0 0 0 0 0 0 0 0 0 0 0 2 1 2 0 0 0 0 0 0 0 0 0 0 0 0 0 3 3 3 3 0
0 0 0 0 0 7 5 5 1 2 0 0 0 0 0 0 0 0 0 0 0 2 2 2 0 0 0 0 0 0 0 0 0 0 0 0 0 0 0 2 1 2 0 0 0 0 0 0 0 0 0 0 0 0 0 3 3 3 3 0
0 0 0 0 0 7 5 5 1 2 2 2 2 0 0 0 0 2 2 2 2 2 1 2 0 0 0 0 0 0 0 3 3 3 3 0 0 0 0 2 1 2 0 0 0 0 0 0 0 0 0 0 0 0 0 3 3 3 3 0
0 0 0 0 0 7 5 5 1 1 1 1 2 0 0 0 0 2 1 1 1 1 1 2 0 0 0 0 0 0 0 3 3 3 3 0 0 0 0 2 1 2 0 0 0 0 0 0 0 0 0 0 0 0 0 3 3 3 3 0
0 0 0 0 0 7 7 7 7 2 2 2 2 0 0 0 0 2 1 2 2 2 2 2 0 0 0 0 0 0 0 3 3 3 3 0 0 0 0 2 2 2 0 0 0 0 0 0 0 0 0 0 0 0 0 0 0 0 0 0
0 0 0 0 0 0 0 0 0 0 0 0 0 0 0 0 0 2 1 2 0 0 0 0 0 0 0 0 0 0 0 3 3 3 3 0 0 0 0 0 0 0 0 0 0 2 2 2 2 0 0 0 2 2 2 2 0 0 0 0
0 0 0 0 0 0 0 0 0 0 0 0 0 0 0 0 0 2 1 2 0 0 0 0 0 0 0 0 0 0 0 0 0 0 0 0 0 0 0 0 0 0 0 0 0 2 1 1 2 0 0 0 2 1 1 2 0 0 0 0
0 0 0 0 0 0 0 0 0 3 3 3 3 0 0 0 0 2 1 2 0 0 0 0 0 0 0 0 0 0 0 0 0 0 0 0 0 0 0 0 0 0 0 0 0 2 1 2 2 6 6 6 2 2 1 2 0 0 0 0
2 2 2 2 2 2 2 0 0 3 3 3 3 0 0 0 0 2 1 2 0 0 0 0 0 0 0 0 0 0 0 0 0 0 2 2 2 2 2 0 0 0 0 0 0 2 2 2 6 6 4 6 6 2 2 2 0 0 0 0
1 1 1 1 1 1 2 0 0 3 3 3 3 0 0 0 0 2 1 2 0 0 0 0 0 0 0 0 0 0 0 0 0 0 2 1 1 1 2 0 0 0 0 0 0 0 0 0 6 4 4 4 6 0 0 0 0 0 0 0
2 2 2 2 2 1 2 0 0 3 3 3 3 0 0 0 0 2 2 2 0 0 0 0 0 0 0 0 0 0 0 0 0 0 2 2 2 2 2 0 0 0 0 0 0 2 2 2 6 6 4 6 6 2 2 2 0 0 0 0
0 0 0 0 2 1 2 0 0 0 0 0 0 0 0 0 0 0 0 0 0 0 0 0 0 0 3 3 3 3 0 0 0 0 0 0 0 0 0 0 0 0 0 0 0 2 1 2 2 6 6 6 2 2 1 2 0 0 0 0
6 6 0 0 2 2 2 0 0 0 0 0 0 0 0 0 0 0 0 0 0 0 0 0 0 0 3 3 3 3 0 0 0 0 0 0 0 0 0 3 3 3 3 0 0 2 1 1 2 0 0 0 2 1 1 2 0 0 7 7
4 6 6 0 0 0 0 0 0 0 0 0 0 0 0 0 0 0 0 0 0 0 0 0 0 0 3 3 3 3 0 0 0 0 0 0 0 0 0 3 3 3 3 0 0 2 2 2 2 0 0 0 2 2 2 2 0 7 7 5
4 4 6 6 0 0 0 0 0 0 0 0 0 0 0 0 0 0 0 0 0 0 0 0 0 0 3 3 3 3 0 0 0 0 0 0 0 0 0 3 3 3 3 0 0 0 0 0 0 0 0 0 0 0 0 0 7 7 5 5
4 4 4 6 0 0 0 0 0 0 0 0 0 0 0 0 0 0 0 0 0 0 0 0 0 0 0 0 0 0 0 0 0 0 0 0 0 0 0 3 3 3 3 0 0 0 0 0 0 0 0 0 0 0 0 0 7 5 5 5
# BASES
4 BASE 0 0 45 28 3 3
4 BASE 0 1 4 56  3 3
# RADAR STATIONS
4 2882343047 0 99 13 44 2 2
4 2882343047 0 99 41 34 2 2
# ENERGY GEN
4 RESGEN_ENER 0 99 2 37 2 2
4 RESGEN_ENER 0 99 8 2 2 2
4 RESGEN_ENER 0 99 7 16 2 2
4 RESGEN_ENER 0 99 11 57 2 2
4 RESGEN_ENER 0 99 15 30 2 2
4 RESGEN_ENER 0 99 23 18 2 2
4 RESGEN_ENER 0 99 32 56 2 2
4 RESGEN_ENER 0 99 34 25 2 2
4 RESGEN_ENER 0 99 37 9 2 2
4 RESGEN_ENER 0 99 48 33 2 2
4 RESGEN_ENER 0 99 53 11 2 2
4 RESGEN_ENER 0 99 58 41 2 2
# MATERIAL GEN
4 RESGEN_MAT 0 99 2 10 2 2
4 RESGEN_MAT 0 99 6 23 2 2
4 RESGEN_MAT 0 99 7 46 2 2
4 RESGEN_MAT 0 99 18 9 2 2
4 RESGEN_MAT 0 99 24 27 2 2
4 RESGEN_MAT 0 99 28 13 2 2
4 RESGEN_MAT 0 99 32 36 2 2
4 RESGEN_MAT 0 99 18 50 2 2
4 RESGEN_MAT 0 99 43 19 2 2
4 RESGEN_MAT 0 99 46 57 2 2
4 RESGEN_MAT 0 99 57 28 2 2
## ROCKS
4 ROCKS 3 99 11 0 1 1
4 ROCKS 7 99 12 0 1 1
4 ROCKS 8 99 13 0 1 1
4 ROCKS 10 99 14 0 1 1
4 ROCKS 4 99 14 1 1 1
4 ROCKS 5 99 14 2 1 1
4 ROCKS 1 99 14 3 1 1
4 ROCKS 0 10 5 1 1
4 ROCKS 6 99 10 6 1 1
4 ROCKS 13 99 10 7 1 1
4 ROCKS 7 99 11 7 1 1
4 ROCKS 2 99 12 7 1 1
4 ROCKS 0 8 5 1 1
4 ROCKS 6 99 8 6 1 1
4 ROCKS 11 99 8 7 1 1
4 ROCKS 9 99 7 7 1 1
4 ROCKS 3 99 6 7 1 1
4 ROCKS 2 99 3 5 1 1
4 ROCKS 9 99 2 5 1 1
4 ROCKS 8 99 1 5 1 1
4 ROCKS 12 99 0 5 1 1
4 ROCKS 5 99 0 6 1 1
4 ROCKS 6 99 0 7 1 1
4 ROCKS 1 99 0 8 1 1
4 ROCKS 0 19 11 1 1
4 ROCKS 4 99 19 12 1 1
4 ROCKS 5 99 19 13 1 1
4 ROCKS 11 99 19 14 1 1
4 ROCKS 7 99 18 14 1 1
4 ROCKS 9 99 17 14 1 1
4 ROCKS 3 99 16 14 1 1
4 ROCKS 2 99 12 11 1 1
4 ROCKS 8 99 11 11 1 1
4 ROCKS 12 99 10 11 1 1
4 ROCKS 5 99 10 12 1 1
4 ROCKS 1 99 10 13 1 1
4 ROCKS 3 99 6 11 1 1
4 ROCKS 8 99 7 11 1 1
4 ROCKS 10 99 8 11 1 1
4 ROCKS 6 99 8 12 1 1
4 ROCKS 1 99 8 13 1 1
4 ROCKS 0 5 16 1 1
4 ROCKS 4 99 5 17 1 1
4 ROCKS 5 99 5 18 1 1
4 ROCKS 13 99 5 19 1 1
4 ROCKS 7 99 6 19 1 1
4 ROCKS 8 99 7 19 1 1
4 ROCKS 9 99 8 19 1 1
4 ROCKS 7 99 9 19 1 1
4 ROCKS 8 99 10 19 1 1
4 ROCKS 2 99 11 19 1 1
# top central
4 ROCKS 0 0 19 1 1
4 ROCKS 6 99 0 20 1 1
4 ROCKS 5 99 0 21 1 1
4 ROCKS 1 99 0 22 1 1
# top-right horizontal 
4 ROCKS 3 99 08 29 1 1
4 ROCKS 7 99 09 29 1 1
4 ROCKS 0 10 27 1 1
4 ROCKS 4 99 10 28 1 1
4 ROCKS 14 99 10 29 1 1
4 ROCKS 6 99 10 30 1 1
4 ROCKS 1 99 10 31 1 1
# central-left T
4 ROCKS 3 99 17 20 1 1
4 ROCKS 7 99 18 20 1 1
4 ROCKS 8 99 19 20 1 1
4 ROCKS 16 99 20 20 1 1
4 ROCKS 9 99 21 20 1 1
4 ROCKS 8 99 22 20 1 1
4 ROCKS 2 99 23 20 1 1
4 ROCKS 0 20 17 1 1
4 ROCKS 4 99 20 18 1 1
4 ROCKS 5 99 20 19 1 1
# central-right T
4 ROCKS 3 99 17 24 1 1
4 ROCKS 7 99 18 24 1 1
4 ROCKS 8 99 19 24 1 1
4 ROCKS 8 99 20 24 1 1
4 ROCKS 17 99 21 24 1 1
4 ROCKS 9 99 22 24 1 1
4 ROCKS 8 99 23 24 1 1
4 ROCKS 7 99 24 24 1 1
4 ROCKS 2 99 25 24 1 1
4 ROCKS 4 99 21 25 1 1
4 ROCKS 5 99 21 26 1 1
4 ROCKS 6 99 21 27 1 1
4 ROCKS 1 99 21 28 1 1
# small vertical bottom-right
4 ROCKS 3 99 26 28 1 1
4 ROCKS 7 99 27 28 1 1
4 ROCKS 2 99 28 28 1 1
# bottom central L
4 ROCKS 0 31 25 1 1
4 ROCKS 6 99 31 26 1 1
4 ROCKS 4 99 31 27 1 1
4 ROCKS 13 99 31 28 1 1
4 ROCKS 7 99 32 28 1 1
4 ROCKS 8 99 33 28 1 1
4 ROCKS 2 99 34 28 1 1
# bottom right T
4 ROCKS 0 24 33 1 1
4 ROCKS 4 99 24 34 1 1
4 ROCKS 3 99 22 35 1 1
4 ROCKS 7 99 23 35 1 1
4 ROCKS 16 99 24 35 1 1
4 ROCKS 8 99 25 35 1 1
4 ROCKS 2 99 26 35 1 1
# big L on bottom left
4 ROCKS 3 99 24 7 1 1
4 ROCKS 7 99 25 7 1 1
4 ROCKS 9 99 26 7 1 1
4 ROCKS 8 99 27 7 1 1
4 ROCKS 9 99 28 7 1 1
4 ROCKS 7 99 29 7 1 1
4 ROCKS 10 99 30 7 1 1
4 ROCKS 4 99 30 8 1 1
4 ROCKS 5 99 30 9 1 1
4 ROCKS 6 99 30 10 1 1
4 ROCKS 4 99 30 11 1 1
4 ROCKS 1 99 30 12 1 1
# small vertical central-bottom
4 ROCKS 3 99 28 19 1 1
4 ROCKS 2 99 29 19 1 1
# bottom left long vertical
4 ROCKS 3 99 22 2 1 1
4 ROCKS 9 99 23 2 1 1
4 ROCKS 8 99 24 2 1 1
4 ROCKS 7 99 25 2 1 1
4 ROCKS 9 99 26 2 1 1
4 ROCKS 9 99 27 2 1 1
4 ROCKS 7 99 28 2 1 1
4 ROCKS 8 99 29 2 1 1
4 ROCKS 9 99 30 2 1 1
4 ROCKS 8 99 31 2 1 1
4 ROCKS 7 99 32 2 1 1
4 ROCKS 10 99 33 2 1 1
4 ROCKS 4 99 33 3 1 1
4 ROCKS 13 99 33 4 1 1
4 ROCKS 9 99 34 4 1 1
4 ROCKS 7 99 35 4 1 1
4 ROCKS 2 99 36 4 1 1
# central top-right
4 ROCKS 3 99 13 35 1 1
4 ROCKS 8 99 14 35 1 1
4 ROCKS 7 99 15 35 1 1
4 ROCKS 2 99 16 35 1 1
# top right small corner
4 ROCKS 12 99 5 36 1 1
4 ROCKS 1 99 5 37 1 1
4 ROCKS 2 99 6 36 1 1
# center bottom horizontal
4 ROCKS 0 38 14 1 1
4 ROCKS 6 99 38 15 1 1
4 ROCKS 5 99 38 16 1 1
4 ROCKS 4 99 38 17 1 1
4 ROCKS 6 99 38 18 1 1
4 ROCKS 1 99 38 19 1 1
# bottom right small corner
4 ROCKS 3 99 36 33 1 1
4 ROCKS 11 99 37 33 1 1
4 ROCKS 0 37 32 1 1
# small top-right
4 ROCKS 3 99 0 45 1 1
4 ROCKS 2 99 1 45 1 1
# vertical top
4 ROCKS 3 99 7  1 1
4 ROCKS 9 99 8  1 1
4 ROCKS 7 99 9  1 1
4 ROCKS 8 99 10  1 1
4 ROCKS 7 99 11  1 1
4 ROCKS 2 99 12  1 1
# inverted L top-right
4 ROCKS 3 99 9 50 1 1
4 ROCKS 8 99 10 50 1 1
4 ROCKS 9 99 11 50 1 1
4 ROCKS 11 99 12 50 1 1
4 ROCKS 0 12 49 1 1
# big horizontal central-right
4 ROCKS 3 99 22 44 1 1
4 ROCKS 9 99 23 44 1 1
4 ROCKS 10 99 24 44 1 1
4 ROCKS 4 99 24 45 1 1
4 ROCKS 5 99 24 46 1 1
4 ROCKS 6 99 24 47 1 1
4 ROCKS 13 99 24 48 1 1
4 ROCKS 8 99 25 48 1 1
4 ROCKS 10 99 26 48 1 1
4 ROCKS 6 99 26 49 1 1
4 ROCKS 5 99 26 50 1 1
4 ROCKS 4 99 26 51 1 1
4 ROCKS 6 99 26 52 1 1
4 ROCKS 4 99 26 53 1 1
4 ROCKS 5 99 26 54 1 1
4 ROCKS 6 99 26 55 1 1
4 ROCKS 1 99 26 56 1 1
# vertical central-right
4 ROCKS 3 99 29 41 1 1
4 ROCKS 9 99 30 41 1 1
4 ROCKS 8 99 31 41 1 1
4 ROCKS 7 99 32 41 1 1
4 ROCKS 2 99 33 41 1 1
# cross right
4 ROCKS 3 99 34 50 1 1
4 ROCKS 7 99 35 50 1 1
4 ROCKS 9 99 36 50 1 1
4 ROCKS 8 99 37 50 1 1
4 ROCKS 18 99 38 50 1 1
4 ROCKS 8 99 39 50 1 1
4 ROCKS 9 99  50 1 1
4 ROCKS 7 99 41 50 1 1
4 ROCKS 2 99 42 50 1 1
4 ROCKS 0 38 47 1 1
4 ROCKS 4 99 38 48 1 1
4 ROCKS 5 99 38 49 1 1
4 ROCKS 6 99 38 51 1 1
4 ROCKS 5 99 38 52 1 1
4 ROCKS 1 99 38 53 1 1
# upside-down L right
4 ROCKS 0 42 39 1 1
4 ROCKS 13 99 42 40 1 1
4 ROCKS 7 99 43  1 1
4 ROCKS 8 99 44  1 1
4 ROCKS 9 99 45  1 1
4 ROCKS 7 99 46  1 1
4 ROCKS 2 99 47  1 1
# little horizontal central-bottom
4 ROCKS 0 53 35 1 1
4 ROCKS 4 99 53 36 1 1
4 ROCKS 1 99 53 37 1 1
# 4 ROCKS corners bottom-right
4 ROCKS 12 99 50 46 1 1
4 ROCKS 1 99 50 47 1 1
4 ROCKS 2 99 51 46 1 1
4 ROCKS 13 99 50 54 1 1
4 ROCKS 0 50 53 1 1
4 ROCKS 2 99 51 54 1 1
4 ROCKS 10 99 56 46 1 1
4 ROCKS 1 99 56 47 1 1
4 ROCKS 3 99 55 46 1 1
4 ROCKS 11 99 56 54 1 1
4 ROCKS 0 56 53 1 1
4 ROCKS 3 99 55 54 1 1
# down L bottom-left
4 ROCKS 0 53 0 1 1
4 ROCKS 4 99 53 1 1 1
4 ROCKS 5 99 53 2 1 1
4 ROCKS 6 99 53 3 1 1
4 ROCKS 5 99 53 4 1 1
4 ROCKS 13 99 53 5 1 1
4 ROCKS 7 99 54 5 1 1
4 ROCKS 2 99 55 5 1 1
# L bottom-left
4 ROCKS 3 99 43 8 1 1
4 ROCKS 7 99 44 8 1 1
4 ROCKS 9 99 45 8 1 1
4 ROCKS 8 99 46 8 1 1
4 ROCKS 10 99 47 8 1 1
4 ROCKS 4 99 47 9 1 1
4 ROCKS 5 99 47 10 1 1
4 ROCKS 1 99 47 11 1 1
# big S next to bottom base
4 ROCKS 3 99 46 22 1 1
4 ROCKS 11 99 47 22 1 1
4 ROCKS 4 99 47 21 1 1
4 ROCKS 5 99 47 20 1 1
4 ROCKS 6 99 47 19 1 1
4 ROCKS 12 99 47 18 1 1
4 ROCKS 7 99 48 18 1 1
4 ROCKS 7 99 49 18 1 1
4 ROCKS 8 99 50 18 1 1
4 ROCKS 8 99 51 18 1 1
4 ROCKS 9 99 52 18 1 1
4 ROCKS 2 99 53 18 1 1
# PRACTICE TARGET
4 TARGET 0 99 54 25 1 1
4 TARGET 0 99 49 25 1 1
4 TARGET 0 99 49 20 1 1
4 TARGET 0 99 54 20 1 1
4 TARGET 0 99 48 1 1
