0.1.0
60 60
5 5 5 7 2 1 1 1 1 3 3 3 0 0 0 0 0 0 2 1 1 1 1 2 0 0 0 0 0 0 0 0 0 0 0 3 3 3 3 0 0 0 0 0 2 1 2 0 0 0 0 0 0 0 0 0 0 0 0 0
5 5 7 7 2 1 2 2 3 3 3 3 0 0 0 0 0 0 2 2 2 2 2 2 0 0 0 0 0 0 0 0 0 0 0 3 3 3 3 0 0 0 0 0 2 1 2 0 0 0 0 0 0 0 0 0 0 0 0 0
5 7 7 0 2 1 2 0 3 3 3 3 0 0 0 0 0 0 0 0 0 0 0 0 0 0 0 0 0 0 0 0 0 0 0 3 3 3 3 0 0 0 0 0 2 2 2 0 0 0 0 0 0 0 0 0 0 0 0 0
7 7 0 0 2 1 2 0 3 3 3 3 0 0 0 0 0 0 0 0 0 0 0 0 0 0 0 0 0 0 0 0 0 0 0 3 3 3 3 0 0 0 0 0 0 0 0 0 0 0 0 0 0 0 0 0 0 0 0 0
0 0 0 0 2 2 2 0 0 0 0 0 0 0 0 2 2 2 2 2 2 3 3 3 3 0 0 0 0 0 0 0 0 0 0 2 2 2 2 0 0 0 0 0 0 0 0 0 0 0 0 0 0 0 0 0 0 0 0 0
0 0 0 0 0 0 2 2 2 0 2 2 2 0 3 3 1 1 1 1 2 3 3 3 3 0 0 0 0 0 0 0 0 0 0 2 1 1 2 0 0 0 0 0 3 3 3 3 0 0 0 0 0 0 0 0 0 0 0 0
3 3 3 3 0 0 2 1 2 0 2 1 2 0 3 3 3 3 2 1 2 3 3 3 3 0 0 0 0 0 0 0 0 0 0 2 1 2 2 2 2 2 0 0 3 3 3 3 0 0 0 0 0 0 0 0 0 0 0 0
3 3 3 3 2 2 2 1 6 6 6 1 2 2 3 3 3 3 2 1 2 3 3 3 3 0 0 0 2 2 2 0 0 0 0 2 2 2 7 7 1 2 0 0 3 3 3 3 0 0 0 0 0 0 0 0 0 0 0 0
3 3 3 3 2 1 1 1 6 4 6 1 1 1 3 3 3 3 2 1 2 0 0 0 0 0 0 0 2 1 2 0 0 0 0 0 0 0 7 5 1 2 0 0 3 3 3 3 0 2 2 2 0 0 0 0 0 0 0 0
3 3 3 3 2 2 2 6 4 4 4 6 2 2 2 0 0 0 2 1 2 0 0 0 0 0 2 2 2 1 2 2 2 0 0 0 0 0 7 5 1 2 0 0 0 0 0 0 0 2 1 2 0 0 0 3 3 3 3 0
2 2 0 0 2 1 1 1 6 4 6 1 1 1 2 0 0 0 2 1 2 0 0 0 0 0 2 1 1 1 1 1 2 0 0 0 0 0 7 5 1 2 0 0 0 0 0 0 0 2 1 2 0 0 0 3 3 3 3 0
1 2 0 0 2 2 2 1 6 6 6 1 2 2 2 0 0 0 2 1 2 0 0 0 0 0 2 2 2 2 2 2 2 0 0 0 0 0 7 5 1 2 3 3 3 3 0 0 2 2 1 2 0 0 0 3 3 3 3 0
1 2 0 0 0 0 2 1 2 0 2 1 2 0 0 0 0 0 2 2 2 0 0 0 0 0 0 0 0 0 0 0 0 0 2 2 2 0 7 7 1 2 3 3 3 3 0 0 2 1 1 2 0 0 0 3 3 3 3 0
1 2 2 2 2 0 2 2 2 0 2 2 2 0 0 0 0 0 0 0 0 0 0 0 0 0 0 0 3 3 3 3 0 0 2 1 2 0 0 2 2 2 3 3 3 3 0 0 2 2 2 2 0 0 0 0 0 0 0 0
1 1 1 1 2 0 0 0 0 0 0 0 0 0 0 0 0 0 0 0 0 0 0 0 0 0 0 0 3 3 3 3 0 0 2 1 2 0 0 0 0 0 3 3 3 3 0 0 0 0 0 0 0 0 0 0 0 0 0 0
2 2 2 2 2 0 0 0 0 0 0 0 0 2 2 2 0 0 0 0 0 0 0 0 0 0 0 0 3 3 3 3 0 0 2 1 2 0 0 0 0 0 0 0 0 0 0 0 0 0 0 0 0 0 0 0 0 0 0 0
0 0 0 0 0 0 0 3 3 3 3 0 0 2 1 2 0 0 7 7 7 2 0 2 2 2 0 0 3 3 3 3 0 0 2 1 2 0 0 0 0 0 0 0 0 0 0 0 3 3 3 3 0 0 0 0 0 0 6 6
0 0 0 0 0 0 0 3 3 3 3 0 0 2 1 2 0 7 7 5 1 2 0 2 1 2 0 0 0 0 0 0 0 0 2 2 2 0 0 0 0 0 0 0 0 0 0 0 3 3 3 3 0 0 0 0 0 0 6 4
0 0 0 0 0 0 0 3 3 3 3 2 2 2 1 2 7 7 5 5 1 2 0 2 1 6 6 0 0 0 0 0 0 0 0 0 0 0 0 0 0 0 0 0 0 0 0 0 3 3 3 3 0 0 0 0 0 0 6 4
0 0 0 0 0 0 0 3 3 3 3 1 1 1 1 2 7 5 5 5 1 2 0 2 1 4 6 6 0 0 0 0 0 0 0 0 0 0 0 0 0 0 0 0 0 0 0 0 3 3 3 3 0 0 0 0 0 0 6 4
0 0 0 0 0 0 0 0 0 0 2 2 2 2 2 2 7 1 1 1 1 2 0 2 1 4 4 6 2 2 0 0 0 0 0 0 0 0 0 0 0 0 0 0 0 0 0 0 0 0 0 0 0 0 0 0 0 0 6 6
0 2 2 2 0 0 0 0 0 0 0 0 0 0 0 0 3 3 3 3 1 2 0 2 1 1 1 1 1 2 0 0 0 0 2 2 2 0 0 0 0 0 0 2 2 2 0 0 0 0 0 0 0 0 0 0 0 0 0 0
0 2 1 2 0 0 0 0 0 0 0 0 0 0 0 0 3 3 3 3 1 2 0 2 1 3 3 3 3 2 0 0 0 0 2 1 2 0 0 0 0 0 0 2 1 2 0 0 0 0 0 0 0 0 0 0 0 0 0 0
0 2 1 2 0 7 7 7 2 0 0 0 0 0 0 0 3 3 3 3 1 2 0 2 1 3 3 3 3 0 0 0 2 2 2 1 2 0 0 0 0 0 0 2 1 2 2 2 2 2 0 0 0 0 0 0 0 0 0 0
0 2 1 2 0 7 5 1 2 0 0 0 0 0 0 0 3 3 3 3 2 2 0 2 1 3 3 3 3 0 0 0 2 1 1 1 2 0 0 0 0 0 0 2 1 1 1 1 1 2 0 0 0 0 0 0 0 0 0 0
0 2 1 2 0 7 5 1 2 0 0 0 0 0 0 0 0 0 0 0 0 0 0 2 1 3 3 3 3 2 0 0 7 5 5 1 2 0 0 0 0 0 0 2 2 2 2 2 1 2 2 2 2 2 2 2 2 2 0 0
0 2 1 2 0 7 5 1 2 0 0 3 3 3 3 0 0 0 0 0 0 0 0 2 2 2 0 2 1 2 0 0 7 7 5 1 2 0 0 0 0 0 0 0 0 0 0 2 1 1 1 1 1 1 1 1 1 2 0 0
0 2 1 2 0 7 5 1 2 0 0 3 3 3 3 0 0 0 2 2 2 0 0 0 0 0 0 2 1 2 0 0 0 7 7 2 2 0 0 0 0 0 0 0 0 0 0 2 2 2 2 2 2 2 2 2 2 2 0 0
0 2 1 2 0 7 5 1 2 0 0 3 3 3 3 0 0 0 2 1 2 0 0 0 0 0 0 2 1 2 0 0 0 0 0 0 0 0 0 0 2 2 2 0 0 0 0 0 0 0 0 0 0 0 0 0 0 0 0 0
0 2 1 2 0 7 5 1 2 2 2 3 3 3 3 0 0 0 2 1 2 0 0 0 0 0 0 2 2 2 0 0 0 0 0 0 0 0 0 0 2 1 2 0 0 0 0 0 0 0 0 0 0 0 0 0 0 0 0 0
0 2 1 2 0 7 5 1 1 1 1 1 1 2 0 0 0 0 2 2 2 0 0 0 2 2 2 2 2 2 0 0 0 0 3 3 3 3 0 0 2 1 2 0 0 0 0 0 0 0 0 0 0 0 3 3 3 3 0 0
0 2 1 2 0 7 7 7 2 2 2 2 2 2 0 0 0 0 0 0 0 0 0 0 2 1 1 1 1 2 0 0 0 0 3 3 3 3 0 0 2 1 2 0 0 0 0 0 0 0 0 0 0 0 3 3 3 3 0 0
0 2 1 2 2 2 0 0 0 0 0 0 0 0 0 0 0 0 0 0 0 0 0 3 3 3 3 2 1 2 0 0 0 0 3 3 3 3 0 0 2 1 2 0 0 0 0 0 0 0 0 0 0 0 3 3 3 3 0 0
0 2 1 1 1 2 0 0 0 0 0 0 0 0 0 0 0 0 0 0 0 0 0 3 3 3 3 2 1 2 0 0 0 0 3 3 3 3 0 0 2 1 2 0 0 0 0 0 0 2 2 2 0 0 3 3 3 3 0 0
0 2 2 2 1 2 0 0 0 0 0 0 0 0 0 0 0 0 0 0 0 0 0 3 3 3 3 2 1 2 0 0 0 0 0 0 0 0 0 0 2 2 2 0 0 0 0 7 7 2 1 2 0 0 0 0 0 0 0 0
0 0 0 2 1 2 0 3 3 3 3 0 0 0 0 0 0 0 0 0 0 0 0 3 3 3 3 2 2 2 0 0 2 2 2 0 0 0 0 0 0 0 0 0 0 0 7 7 5 2 1 2 0 0 0 0 0 0 0 0
0 0 0 2 1 2 0 3 3 3 3 0 0 0 0 0 0 0 0 0 0 0 0 0 0 0 0 0 0 0 0 2 2 1 2 0 0 0 0 0 0 0 0 0 0 0 7 5 5 2 1 2 0 0 0 0 0 0 0 0
0 0 0 2 2 2 0 3 3 3 3 0 0 2 2 2 2 2 2 2 2 0 0 0 0 0 0 0 0 0 0 2 1 1 2 0 0 0 0 0 0 0 0 0 0 0 2 2 2 2 1 2 2 2 2 0 0 0 0 0
0 0 0 0 0 0 0 3 3 3 3 0 0 2 1 1 1 1 1 1 2 0 0 0 0 0 0 0 0 0 0 2 2 2 2 0 0 0 0 0 0 0 0 0 0 0 2 1 1 1 1 1 1 1 2 0 0 0 0 0
0 0 0 0 0 0 0 0 0 0 0 0 0 2 2 2 2 2 2 2 2 0 0 0 0 0 0 0 0 0 0 0 3 3 3 3 0 0 0 0 0 0 0 0 0 0 2 2 2 2 1 2 2 2 2 0 0 0 0 0
0 0 0 0 0 0 0 0 0 0 0 0 0 0 0 0 0 0 0 0 0 0 0 0 0 0 0 0 0 0 0 0 3 3 3 3 0 0 0 0 0 0 0 0 0 0 0 0 0 2 1 2 0 0 0 0 0 0 0 0
0 0 0 0 0 0 0 0 0 0 0 0 0 0 0 0 0 3 3 3 3 0 0 0 0 0 0 0 0 0 0 0 3 3 3 3 0 0 2 2 2 2 0 0 0 0 0 0 0 2 1 2 0 0 0 0 0 0 0 0
0 0 0 0 0 7 7 7 7 2 0 0 0 0 0 0 0 3 3 3 3 0 0 0 0 0 0 0 0 0 0 0 3 3 3 3 0 0 2 1 1 2 0 0 0 0 0 0 0 2 1 2 0 0 0 0 0 0 0 0
0 0 0 0 0 7 5 5 1 2 0 0 0 0 0 0 0 3 3 3 3 0 0 0 0 0 0 0 0 0 0 0 0 0 0 0 0 0 2 2 1 2 0 0 0 0 0 0 0 2 2 2 0 0 0 0 0 0 0 0
0 0 0 0 0 7 5 5 1 2 0 0 0 0 0 0 0 3 3 3 3 0 0 0 0 0 0 0 0 0 0 0 0 0 0 0 0 0 0 2 1 2 0 0 0 0 0 0 0 0 0 0 0 0 0 3 3 3 3 0
0 0 0 0 0 7 5 5 1 2 0 0 0 0 0 0 0 0 0 0 0 2 2 2 0 0 0 0 0 0 0 0 0 0 0 0 0 0 0 2 1 2 0 0 0 0 0 0 0 0 0 0 0 0 0 3 3 3 3 0
0 0 0 0 0 7 5 5 1 2 2 2 2 0 0 0 0 2 2 2 2 2 1 2 0 0 0 0 0 0 0 3 3 3 3 0 0 0 0 2 1 2 0 0 0 0 0 0 0 0 0 0 0 0 0 3 3 3 3 0
0 0 0 0 0 7 5 5 1 1 1 1 2 0 0 0 0 2 1 1 1 1 1 2 0 0 0 0 0 0 0 3 3 3 3 0 0 0 0 2 1 2 0 0 0 0 0 0 0 0 0 0 0 0 0 3 3 3 3 0
0 0 0 0 0 7 7 7 7 2 2 2 2 0 0 0 0 2 1 2 2 2 2 2 0 0 0 0 0 0 0 3 3 3 3 0 0 0 0 2 2 2 0 0 0 0 0 0 0 0 0 0 0 0 0 0 0 0 0 0
0 0 0 0 0 0 0 0 0 0 0 0 0 0 0 0 0 2 1 2 0 0 0 0 0 0 0 0 0 0 0 3 3 3 3 0 0 0 0 0 0 0 0 0 0 2 2 2 2 0 0 0 2 2 2 2 0 0 0 0
0 0 0 0 0 0 0 0 0 0 0 0 0 0 0 0 0 2 1 2 0 0 0 0 0 0 0 0 0 0 0 0 0 0 0 0 0 0 0 0 0 0 0 0 0 2 1 1 2 0 0 0 2 1 1 2 0 0 0 0
0 0 0 0 0 0 0 0 0 3 3 3 3 0 0 0 0 2 1 2 0 0 0 0 0 0 0 0 0 0 0 0 0 0 0 0 0 0 0 0 0 0 0 0 0 2 1 2 2 6 6 6 2 2 1 2 0 0 0 0
2 2 2 2 2 2 2 0 0 3 3 3 3 0 0 0 0 2 1 2 0 0 0 0 0 0 0 0 0 0 0 0 0 0 2 2 2 2 2 0 0 0 0 0 0 2 2 2 6 6 4 6 6 2 2 2 0 0 0 0
1 1 1 1 1 1 2 0 0 3 3 3 3 0 0 0 0 2 1 2 0 0 0 0 0 0 0 0 0 0 0 0 0 0 2 1 1 1 2 0 0 0 0 0 0 0 0 0 6 4 4 4 6 0 0 0 0 0 0 0
2 2 2 2 2 1 2 0 0 3 3 3 3 0 0 0 0 2 2 2 0 0 0 0 0 0 0 0 0 0 0 0 0 0 2 2 2 2 2 0 0 0 0 0 0 2 2 2 6 6 4 6 6 2 2 2 0 0 0 0
0 0 0 0 2 1 2 0 0 0 0 0 0 0 0 0 0 0 0 0 0 0 0 0 0 0 3 3 3 3 0 0 0 0 0 0 0 0 0 0 0 0 0 0 0 2 1 2 2 6 6 6 2 2 1 2 0 0 0 0
6 6 0 0 2 2 2 0 0 0 0 0 0 0 0 0 0 0 0 0 0 0 0 0 0 0 3 3 3 3 0 0 0 0 0 0 0 0 0 3 3 3 3 0 0 2 1 1 2 0 0 0 2 1 1 2 0 0 7 7
4 6 6 0 0 0 0 0 0 0 0 0 0 0 0 0 0 0 0 0 0 0 0 0 0 0 3 3 3 3 0 0 0 0 0 0 0 0 0 3 3 3 3 0 0 2 2 2 2 0 0 0 2 2 2 2 0 7 7 5
4 4 6 6 0 0 0 0 0 0 0 0 0 0 0 0 0 0 0 0 0 0 0 0 0 0 3 3 3 3 0 0 0 0 0 0 0 0 0 3 3 3 3 0 0 0 0 0 0 0 0 0 0 0 0 0 7 7 5 5
4 4 4 6 0 0 0 0 0 0 0 0 0 0 0 0 0 0 0 0 0 0 0 0 0 0 0 0 0 0 0 0 0 0 0 0 0 0 0 3 3 3 3 0 0 0 0 0 0 0 0 0 0 0 0 0 7 5 5 5
# BASES
4 BASE_SPOT 0 99 45 28
4 BASE_SPOT 1 99 4 56
# RADAR STATIONS
4 2882343047 0 99 13 44
4 2882343047 0 99 41 34
# ENERGY GEN
4 RESGEN_ENER 0 99 2 37
4 RESGEN_ENER 0 99 8 2
4 RESGEN_ENER 0 99 7 16
4 RESGEN_ENER 0 99 11 57
4 RESGEN_ENER 0 99 15 30
4 RESGEN_ENER 0 99 23 18
4 RESGEN_ENER 0 99 32 56
4 RESGEN_ENER 0 99 34 25
4 RESGEN_ENER 0 99 37 9
4 RESGEN_ENER 0 99 48 33
4 RESGEN_ENER 0 99 53 11
4 RESGEN_ENER 0 99 58 41
# MATERIAL GEN
4 RESGEN_MAT 0 99 2 10
4 RESGEN_MAT 0 99 6 23
4 RESGEN_MAT 0 99 7 46
4 RESGEN_MAT 0 99 18 9
4 RESGEN_MAT 0 99 24 27
4 RESGEN_MAT 0 99 28 13
4 RESGEN_MAT 0 99 32 36
4 RESGEN_MAT 0 99 18 50
4 RESGEN_MAT 0 99 43 19
4 RESGEN_MAT 0 99 46 57
4 RESGEN_MAT 0 99 57 28
## ROCKS
4 ROCKS 3 99 11 0
4 ROCKS 7 99 12 0
4 ROCKS 8 99 13 0
4 ROCKS 10 99 14 0
4 ROCKS 4 99 14 1
4 ROCKS 5 99 14 2
4 ROCKS 1 99 14 3
4 ROCKS 0 10 5
4 ROCKS 6 99 10 6
4 ROCKS 13 99 10 7
4 ROCKS 7 99 11 7
4 ROCKS 2 99 12 7
4 ROCKS 0 8 5
4 ROCKS 6 99 8 6
4 ROCKS 11 99 8 7
4 ROCKS 9 99 7 7
4 ROCKS 3 99 6 7
4 ROCKS 2 99 3 5
4 ROCKS 9 99 2 5
4 ROCKS 8 99 1 5
4 ROCKS 12 99 0 5
4 ROCKS 5 99 0 6
4 ROCKS 6 99 0 7
4 ROCKS 1 99 0 8
4 ROCKS 0 19 11
4 ROCKS 4 99 19 12
4 ROCKS 5 99 19 13
4 ROCKS 11 99 19 14
4 ROCKS 7 99 18 14
4 ROCKS 9 99 17 14
4 ROCKS 3 99 16 14
4 ROCKS 2 99 12 11
4 ROCKS 8 99 11 11
4 ROCKS 12 99 10 11
4 ROCKS 5 99 10 12
4 ROCKS 1 99 10 13
4 ROCKS 3 99 6 11
4 ROCKS 8 99 7 11
4 ROCKS 10 99 8 11
4 ROCKS 6 99 8 12
4 ROCKS 1 99 8 13
4 ROCKS 0 5 16
4 ROCKS 4 99 5 17
4 ROCKS 5 99 5 18
4 ROCKS 13 99 5 19
4 ROCKS 7 99 6 19
4 ROCKS 8 99 7 19
4 ROCKS 9 99 8 19
4 ROCKS 7 99 9 19
4 ROCKS 8 99 10 19
4 ROCKS 2 99 11 19
# top central
4 ROCKS 0 0 19
4 ROCKS 6 99 0 20
4 ROCKS 5 99 0 21
4 ROCKS 1 99 0 22
# top-right horizontal 
4 ROCKS 3 99 08 29
4 ROCKS 7 99 09 29
4 ROCKS 0 10 27
4 ROCKS 4 99 10 28
4 ROCKS 14 99 10 29
4 ROCKS 6 99 10 30
4 ROCKS 1 99 10 31
# central-left T
4 ROCKS 3 99 17 20
4 ROCKS 7 99 18 20
4 ROCKS 8 99 19 20
4 ROCKS 16 99 20 20
4 ROCKS 9 99 21 20
4 ROCKS 8 99 22 20
4 ROCKS 2 99 23 20
4 ROCKS 0 20 17
4 ROCKS 4 99 20 18
4 ROCKS 5 99 20 19
# central-right T
4 ROCKS 3 99 17 24
4 ROCKS 7 99 18 24
4 ROCKS 8 99 19 24
4 ROCKS 8 99 20 24
4 ROCKS 17 99 21 24
4 ROCKS 9 99 22 24
4 ROCKS 8 99 23 24
4 ROCKS 7 99 24 24
4 ROCKS 2 99 25 24
4 ROCKS 4 99 21 25
4 ROCKS 5 99 21 26
4 ROCKS 6 99 21 27
4 ROCKS 1 99 21 28
# small vertical bottom-right
4 ROCKS 3 99 26 28
4 ROCKS 7 99 27 28
4 ROCKS 2 99 28 28
# bottom central L
4 ROCKS 0 31 25
4 ROCKS 6 99 31 26
4 ROCKS 4 99 31 27
4 ROCKS 13 99 31 28
4 ROCKS 7 99 32 28
4 ROCKS 8 99 33 28
4 ROCKS 2 99 34 28
# bottom right T
4 ROCKS 0 24 33
4 ROCKS 4 99 24 34
4 ROCKS 3 99 22 35
4 ROCKS 7 99 23 35
4 ROCKS 16 99 24 35
4 ROCKS 8 99 25 35
4 ROCKS 2 99 26 35
# big L on bottom left
4 ROCKS 3 99 24 7
4 ROCKS 7 99 25 7
4 ROCKS 9 99 26 7
4 ROCKS 8 99 27 7
4 ROCKS 9 99 28 7
4 ROCKS 7 99 29 7
4 ROCKS 10 99 30 7
4 ROCKS 4 99 30 8
4 ROCKS 5 99 30 9
4 ROCKS 6 99 30 10
4 ROCKS 4 99 30 11
4 ROCKS 1 99 30 12
# small vertical central-bottom
4 ROCKS 3 99 28 19
4 ROCKS 2 99 29 19
# bottom left long vertical
4 ROCKS 3 99 22 2
4 ROCKS 9 99 23 2
4 ROCKS 8 99 24 2
4 ROCKS 7 99 25 2
4 ROCKS 9 99 26 2
4 ROCKS 9 99 27 2
4 ROCKS 7 99 28 2
4 ROCKS 8 99 29 2
4 ROCKS 9 99 30 2
4 ROCKS 8 99 31 2
4 ROCKS 7 99 32 2
4 ROCKS 10 99 33 2
4 ROCKS 4 99 33 3
4 ROCKS 13 99 33 4
4 ROCKS 9 99 34 4
4 ROCKS 7 99 35 4
4 ROCKS 2 99 36 4
# central top-right
4 ROCKS 3 99 13 35
4 ROCKS 8 99 14 35
4 ROCKS 7 99 15 35
4 ROCKS 2 99 16 35
# top right small corner
4 ROCKS 12 99 5 36
4 ROCKS 1 99 5 37
4 ROCKS 2 99 6 36
# center bottom horizontal
4 ROCKS 0 38 14
4 ROCKS 6 99 38 15
4 ROCKS 5 99 38 16
4 ROCKS 4 99 38 17
4 ROCKS 6 99 38 18
4 ROCKS 1 99 38 19
# bottom right small corner
4 ROCKS 3 99 36 33
4 ROCKS 11 99 37 33
4 ROCKS 0 37 32
# small top-right
4 ROCKS 3 99 0 45
4 ROCKS 2 99 1 45
# vertical top
4 ROCKS 3 99 7
4 ROCKS 9 99 8
4 ROCKS 7 99 9
4 ROCKS 8 99 10
4 ROCKS 7 99 11
4 ROCKS 2 99 12
# inverted L top-right
4 ROCKS 3 99 9 50
4 ROCKS 8 99 10 50
4 ROCKS 9 99 11 50
4 ROCKS 11 99 12 50
4 ROCKS 0 12 49
# big horizontal central-right
4 ROCKS 3 99 22 44
4 ROCKS 9 99 23 44
4 ROCKS 10 99 24 44
4 ROCKS 4 99 24 45
4 ROCKS 5 99 24 46
4 ROCKS 6 99 24 47
4 ROCKS 13 99 24 48
4 ROCKS 8 99 25 48
4 ROCKS 10 99 26 48
4 ROCKS 6 99 26 49
4 ROCKS 5 99 26 50
4 ROCKS 4 99 26 51
4 ROCKS 6 99 26 52
4 ROCKS 4 99 26 53
4 ROCKS 5 99 26 54
4 ROCKS 6 99 26 55
4 ROCKS 1 99 26 56
# vertical central-right
4 ROCKS 3 99 29 41
4 ROCKS 9 99 30 41
4 ROCKS 8 99 31 41
4 ROCKS 7 99 32 41
4 ROCKS 2 99 33 41
# cross right
4 ROCKS 3 99 34 50
4 ROCKS 7 99 35 50
4 ROCKS 9 99 36 50
4 ROCKS 8 99 37 50
4 ROCKS 18 99 38 50
4 ROCKS 8 99 39 50
4 ROCKS 9 99  50
4 ROCKS 7 99 41 50
4 ROCKS 2 99 42 50
4 ROCKS 0 38 47
4 ROCKS 4 99 38 48
4 ROCKS 5 99 38 49
4 ROCKS 6 99 38 51
4 ROCKS 5 99 38 52
4 ROCKS 1 99 38 53
# upside-down L right
4 ROCKS 0 42 39
4 ROCKS 13 99 42 40
4 ROCKS 7 99 43
4 ROCKS 8 99 44
4 ROCKS 9 99 45
4 ROCKS 7 99 46
4 ROCKS 2 99 47
# little horizontal central-bottom
4 ROCKS 0 53 35
4 ROCKS 4 99 53 36
4 ROCKS 1 99 53 37
# 4 ROCKS corners bottom-right
4 ROCKS 12 99 50 46
4 ROCKS 1 99 50 47
4 ROCKS 2 99 51 46
4 ROCKS 13 99 50 54
4 ROCKS 0 50 53
4 ROCKS 2 99 51 54
4 ROCKS 10 99 56 46
4 ROCKS 1 99 56 47
4 ROCKS 3 99 55 46
4 ROCKS 11 99 56 54
4 ROCKS 0 56 53
4 ROCKS 3 99 55 54
# down L bottom-left
4 ROCKS 0 53 0
4 ROCKS 4 99 53 1
4 ROCKS 5 99 53 2
4 ROCKS 6 99 53 3
4 ROCKS 5 99 53 4
4 ROCKS 13 99 53 5
4 ROCKS 7 99 54 5
4 ROCKS 2 99 55 5
# L bottom-left
4 ROCKS 3 99 43 8
4 ROCKS 7 99 44 8
4 ROCKS 9 99 45 8
4 ROCKS 8 99 46 8
4 ROCKS 10 99 47 8
4 ROCKS 4 99 47 9
4 ROCKS 5 99 47 10
4 ROCKS 1 99 47 11
# big S next to bottom base
4 ROCKS 3 99 46 22
4 ROCKS 11 99 47 22
4 ROCKS 4 99 47 21
4 ROCKS 5 99 47 20
4 ROCKS 6 99 47 19
4 ROCKS 12 99 47 18
4 ROCKS 7 99 48 18
4 ROCKS 7 99 49 18
4 ROCKS 8 99 50 18
4 ROCKS 8 99 51 18
4 ROCKS 9 99 52 18
4 ROCKS 2 99 53 18
# PRACTICE TARGET
4 TARGET 0 99 54 25
4 TARGET 0 99 49 25
4 TARGET 0 99 49 20
4 TARGET 0 99 54 20
