60 60
5 5 5 7 2 1 1 1 1 3 3 3 0 0 0 0 0 0 2 1 1 1 1 2 0 0 0 0 0 0 0 0 0 0 0 3 3 3 3 0 0 0 0 0 2 1 2 0 0 0 0 0 0 0 0 0 0 0 0 0
5 5 7 7 2 1 2 2 3 3 3 3 0 0 0 0 0 0 2 2 2 2 2 2 0 0 0 0 0 0 0 0 0 0 0 3 3 3 3 0 0 0 0 0 2 1 2 0 0 0 0 0 0 0 0 0 0 0 0 0
5 7 7 0 2 1 2 0 3 3 3 3 0 0 0 0 0 0 0 0 0 0 0 0 0 0 0 0 0 0 0 0 0 0 0 3 3 3 3 0 0 0 0 0 2 2 2 0 0 0 0 0 0 0 0 0 0 0 0 0
7 7 0 0 2 1 2 0 3 3 3 3 0 0 0 0 0 0 0 0 0 0 0 0 0 0 0 0 0 0 0 0 0 0 0 3 3 3 3 0 0 0 0 0 0 0 0 0 0 0 0 0 0 0 0 0 0 0 0 0
0 0 0 0 2 2 2 0 0 0 0 0 0 0 0 2 2 2 2 2 2 3 3 3 3 0 0 0 0 0 0 0 0 0 0 2 2 2 2 0 0 0 0 0 0 0 0 0 0 0 0 0 0 0 0 0 0 0 0 0
0 0 0 0 0 0 2 2 2 0 2 2 2 0 3 3 1 1 1 1 2 3 3 3 3 0 0 0 0 0 0 0 0 0 0 2 1 1 2 0 0 0 0 0 3 3 3 3 0 0 0 0 0 0 0 0 0 0 0 0
3 3 3 3 0 0 2 1 2 0 2 1 2 0 3 3 3 3 2 1 2 3 3 3 3 0 0 0 0 0 0 0 0 0 0 2 1 2 2 2 2 2 0 0 3 3 3 3 0 0 0 0 0 0 0 0 0 0 0 0
3 3 3 3 2 2 2 1 6 6 6 1 2 2 3 3 3 3 2 1 2 3 3 3 3 0 0 0 2 2 2 0 0 0 0 2 2 2 7 7 1 2 0 0 3 3 3 3 0 0 0 0 0 0 0 0 0 0 0 0
3 3 3 3 2 1 1 1 6 4 6 1 1 1 3 3 3 3 2 1 2 0 0 0 0 0 0 0 2 1 2 0 0 0 0 0 0 0 7 5 1 2 0 0 3 3 3 3 0 2 2 2 0 0 0 0 0 0 0 0
3 3 3 3 2 2 2 6 4 4 4 6 2 2 2 0 0 0 2 1 2 0 0 0 0 0 2 2 2 1 2 2 2 0 0 0 0 0 7 5 1 2 0 0 0 0 0 0 0 2 1 2 0 0 0 3 3 3 3 0
2 2 0 0 2 1 1 1 6 4 6 1 1 1 2 0 0 0 2 1 2 0 0 0 0 0 2 1 1 1 1 1 2 0 0 0 0 0 7 5 1 2 0 0 0 0 0 0 0 2 1 2 0 0 0 3 3 3 3 0
1 2 0 0 2 2 2 1 6 6 6 1 2 2 2 0 0 0 2 1 2 0 0 0 0 0 2 2 2 2 2 2 2 0 0 0 0 0 7 5 1 2 3 3 3 3 0 0 2 2 1 2 0 0 0 3 3 3 3 0
1 2 0 0 0 0 2 1 2 0 2 1 2 0 0 0 0 0 2 2 2 0 0 0 0 0 0 0 0 0 0 0 0 0 2 2 2 0 7 7 1 2 3 3 3 3 0 0 2 1 1 2 0 0 0 3 3 3 3 0
1 2 2 2 2 0 2 2 2 0 2 2 2 0 0 0 0 0 0 0 0 0 0 0 0 0 0 0 3 3 3 3 0 0 2 1 2 0 0 2 2 2 3 3 3 3 0 0 2 2 2 2 0 0 0 0 0 0 0 0
1 1 1 1 2 0 0 0 0 0 0 0 0 0 0 0 0 0 0 0 0 0 0 0 0 0 0 0 3 3 3 3 0 0 2 1 2 0 0 0 0 0 3 3 3 3 0 0 0 0 0 0 0 0 0 0 0 0 0 0
2 2 2 2 2 0 0 0 0 0 0 0 0 2 2 2 0 0 0 0 0 0 0 0 0 0 0 0 3 3 3 3 0 0 2 1 2 0 0 0 0 0 0 0 0 0 0 0 0 0 0 0 0 0 0 0 0 0 0 0
0 0 0 0 0 0 0 3 3 3 3 0 0 2 1 2 0 0 7 7 7 2 0 2 2 2 0 0 3 3 3 3 0 0 2 1 2 0 0 0 0 0 0 0 0 0 0 0 3 3 3 3 0 0 0 0 0 0 6 6
0 0 0 0 0 0 0 3 3 3 3 0 0 2 1 2 0 7 7 5 1 2 0 2 1 2 0 0 0 0 0 0 0 0 2 2 2 0 0 0 0 0 0 0 0 0 0 0 3 3 3 3 0 0 0 0 0 0 6 4
0 0 0 0 0 0 0 3 3 3 3 2 2 2 1 2 7 7 5 5 1 2 0 2 1 6 6 0 0 0 0 0 0 0 0 0 0 0 0 0 0 0 0 0 0 0 0 0 3 3 3 3 0 0 0 0 0 0 6 4
0 0 0 0 0 0 0 3 3 3 3 1 1 1 1 2 7 5 5 5 1 2 0 2 1 4 6 6 0 0 0 0 0 0 0 0 0 0 0 0 0 0 0 0 0 0 0 0 3 3 3 3 0 0 0 0 0 0 6 4
0 0 0 0 0 0 0 0 0 0 2 2 2 2 2 2 7 1 1 1 1 2 0 2 1 4 4 6 2 2 0 0 0 0 0 0 0 0 0 0 0 0 0 0 0 0 0 0 0 0 0 0 0 0 0 0 0 0 6 6
0 2 2 2 0 0 0 0 0 0 0 0 0 0 0 0 3 3 3 3 1 2 0 2 1 1 1 1 1 2 0 0 0 0 2 2 2 0 0 0 0 0 0 2 2 2 0 0 0 0 0 0 0 0 0 0 0 0 0 0
0 2 1 2 0 0 0 0 0 0 0 0 0 0 0 0 3 3 3 3 1 2 0 2 1 3 3 3 3 2 0 0 0 0 2 1 2 0 0 0 0 0 0 2 1 2 0 0 0 0 0 0 0 0 0 0 0 0 0 0
0 2 1 2 0 7 7 7 2 0 0 0 0 0 0 0 3 3 3 3 1 2 0 2 1 3 3 3 3 0 0 0 2 2 2 1 2 0 0 0 0 0 0 2 1 2 2 2 2 2 0 0 0 0 0 0 0 0 0 0
0 2 1 2 0 7 5 1 2 0 0 0 0 0 0 0 3 3 3 3 2 2 0 2 1 3 3 3 3 0 0 0 2 1 1 1 2 0 0 0 0 0 0 2 1 1 1 1 1 2 0 0 0 0 0 0 0 0 0 0
0 2 1 2 0 7 5 1 2 0 0 0 0 0 0 0 0 0 0 0 0 0 0 2 1 3 3 3 3 2 0 0 7 5 5 1 2 0 0 0 0 0 0 2 2 2 2 2 1 2 2 2 2 2 2 2 2 2 0 0
0 2 1 2 0 7 5 1 2 0 0 3 3 3 3 0 0 0 0 0 0 0 0 2 2 2 0 2 1 2 0 0 7 7 5 1 2 0 0 0 0 0 0 0 0 0 0 2 1 1 1 1 1 1 1 1 1 2 0 0
0 2 1 2 0 7 5 1 2 0 0 3 3 3 3 0 0 0 2 2 2 0 0 0 0 0 0 2 1 2 0 0 0 7 7 2 2 0 0 0 0 0 0 0 0 0 0 2 2 2 2 2 2 2 2 2 2 2 0 0
0 2 1 2 0 7 5 1 2 0 0 3 3 3 3 0 0 0 2 1 2 0 0 0 0 0 0 2 1 2 0 0 0 0 0 0 0 0 0 0 2 2 2 0 0 0 0 0 0 0 0 0 0 0 0 0 0 0 0 0
0 2 1 2 0 7 5 1 2 2 2 3 3 3 3 0 0 0 2 1 2 0 0 0 0 0 0 2 2 2 0 0 0 0 0 0 0 0 0 0 2 1 2 0 0 0 0 0 0 0 0 0 0 0 0 0 0 0 0 0
0 2 1 2 0 7 5 1 1 1 1 1 1 2 0 0 0 0 2 2 2 0 0 0 2 2 2 2 2 2 0 0 0 0 3 3 3 3 0 0 2 1 2 0 0 0 0 0 0 0 0 0 0 0 3 3 3 3 0 0
0 2 1 2 0 7 7 7 2 2 2 2 2 2 0 0 0 0 0 0 0 0 0 0 2 1 1 1 1 2 0 0 0 0 3 3 3 3 0 0 2 1 2 0 0 0 0 0 0 0 0 0 0 0 3 3 3 3 0 0
0 2 1 2 2 2 0 0 0 0 0 0 0 0 0 0 0 0 0 0 0 0 0 3 3 3 3 2 1 2 0 0 0 0 3 3 3 3 0 0 2 1 2 0 0 0 0 0 0 0 0 0 0 0 3 3 3 3 0 0
0 2 1 1 1 2 0 0 0 0 0 0 0 0 0 0 0 0 0 0 0 0 0 3 3 3 3 2 1 2 0 0 0 0 3 3 3 3 0 0 2 1 2 0 0 0 0 0 0 2 2 2 0 0 3 3 3 3 0 0
0 2 2 2 1 2 0 0 0 0 0 0 0 0 0 0 0 0 0 0 0 0 0 3 3 3 3 2 1 2 0 0 0 0 0 0 0 0 0 0 2 2 2 0 0 0 0 7 7 2 1 2 0 0 0 0 0 0 0 0
0 0 0 2 1 2 0 3 3 3 3 0 0 0 0 0 0 0 0 0 0 0 0 3 3 3 3 2 2 2 0 0 2 2 2 0 0 0 0 0 0 0 0 0 0 0 7 7 5 2 1 2 0 0 0 0 0 0 0 0
0 0 0 2 1 2 0 3 3 3 3 0 0 0 0 0 0 0 0 0 0 0 0 0 0 0 0 0 0 0 0 2 2 1 2 0 0 0 0 0 0 0 0 0 0 0 7 5 5 2 1 2 0 0 0 0 0 0 0 0
0 0 0 2 2 2 0 3 3 3 3 0 0 2 2 2 2 2 2 2 2 0 0 0 0 0 0 0 0 0 0 2 1 1 2 0 0 0 0 0 0 0 0 0 0 0 2 2 2 2 1 2 2 2 2 0 0 0 0 0
0 0 0 0 0 0 0 3 3 3 3 0 0 2 1 1 1 1 1 1 2 0 0 0 0 0 0 0 0 0 0 2 2 2 2 0 0 0 0 0 0 0 0 0 0 0 2 1 1 1 1 1 1 1 2 0 0 0 0 0
0 0 0 0 0 0 0 0 0 0 0 0 0 2 2 2 2 2 2 2 2 0 0 0 0 0 0 0 0 0 0 0 3 3 3 3 0 0 0 0 0 0 0 0 0 0 2 2 2 2 1 2 2 2 2 0 0 0 0 0
0 0 0 0 0 0 0 0 0 0 0 0 0 0 0 0 0 0 0 0 0 0 0 0 0 0 0 0 0 0 0 0 3 3 3 3 0 0 0 0 0 0 0 0 0 0 0 0 0 2 1 2 0 0 0 0 0 0 0 0
0 0 0 0 0 0 0 0 0 0 0 0 0 0 0 0 0 3 3 3 3 0 0 0 0 0 0 0 0 0 0 0 3 3 3 3 0 0 2 2 2 2 0 0 0 0 0 0 0 2 1 2 0 0 0 0 0 0 0 0
0 0 0 0 0 7 7 7 7 2 0 0 0 0 0 0 0 3 3 3 3 0 0 0 0 0 0 0 0 0 0 0 3 3 3 3 0 0 2 1 1 2 0 0 0 0 0 0 0 2 1 2 0 0 0 0 0 0 0 0
0 0 0 0 0 7 5 5 1 2 0 0 0 0 0 0 0 3 3 3 3 0 0 0 0 0 0 0 0 0 0 0 0 0 0 0 0 0 2 2 1 2 0 0 0 0 0 0 0 2 2 2 0 0 0 0 0 0 0 0
0 0 0 0 0 7 5 5 1 2 0 0 0 0 0 0 0 3 3 3 3 0 0 0 0 0 0 0 0 0 0 0 0 0 0 0 0 0 0 2 1 2 0 0 0 0 0 0 0 0 0 0 0 0 0 3 3 3 3 0
0 0 0 0 0 7 5 5 1 2 0 0 0 0 0 0 0 0 0 0 0 2 2 2 0 0 0 0 0 0 0 0 0 0 0 0 0 0 0 2 1 2 0 0 0 0 0 0 0 0 0 0 0 0 0 3 3 3 3 0
0 0 0 0 0 7 5 5 1 2 2 2 2 0 0 0 0 2 2 2 2 2 1 2 0 0 0 0 0 0 0 3 3 3 3 0 0 0 0 2 1 2 0 0 0 0 0 0 0 0 0 0 0 0 0 3 3 3 3 0
0 0 0 0 0 7 5 5 1 1 1 1 2 0 0 0 0 2 1 1 1 1 1 2 0 0 0 0 0 0 0 3 3 3 3 0 0 0 0 2 1 2 0 0 0 0 0 0 0 0 0 0 0 0 0 3 3 3 3 0
0 0 0 0 0 7 7 7 7 2 2 2 2 0 0 0 0 2 1 2 2 2 2 2 0 0 0 0 0 0 0 3 3 3 3 0 0 0 0 2 2 2 0 0 0 0 0 0 0 0 0 0 0 0 0 0 0 0 0 0
0 0 0 0 0 0 0 0 0 0 0 0 0 0 0 0 0 2 1 2 0 0 0 0 0 0 0 0 0 0 0 3 3 3 3 0 0 0 0 0 0 0 0 0 0 2 2 2 2 0 0 0 2 2 2 2 0 0 0 0
0 0 0 0 0 0 0 0 0 0 0 0 0 0 0 0 0 2 1 2 0 0 0 0 0 0 0 0 0 0 0 0 0 0 0 0 0 0 0 0 0 0 0 0 0 2 1 1 2 0 0 0 2 1 1 2 0 0 0 0
0 0 0 0 0 0 0 0 0 3 3 3 3 0 0 0 0 2 1 2 0 0 0 0 0 0 0 0 0 0 0 0 0 0 0 0 0 0 0 0 0 0 0 0 0 2 1 2 2 6 6 6 2 2 1 2 0 0 0 0
2 2 2 2 2 2 2 0 0 3 3 3 3 0 0 0 0 2 1 2 0 0 0 0 0 0 0 0 0 0 0 0 0 0 2 2 2 2 2 0 0 0 0 0 0 2 2 2 6 6 4 6 6 2 2 2 0 0 0 0
1 1 1 1 1 1 2 0 0 3 3 3 3 0 0 0 0 2 1 2 0 0 0 0 0 0 0 0 0 0 0 0 0 0 2 1 1 1 2 0 0 0 0 0 0 0 0 0 6 4 4 4 6 0 0 0 0 0 0 0
2 2 2 2 2 1 2 0 0 3 3 3 3 0 0 0 0 2 2 2 0 0 0 0 0 0 0 0 0 0 0 0 0 0 2 2 2 2 2 0 0 0 0 0 0 2 2 2 6 6 4 6 6 2 2 2 0 0 0 0
0 0 0 0 2 1 2 0 0 0 0 0 0 0 0 0 0 0 0 0 0 0 0 0 0 0 3 3 3 3 0 0 0 0 0 0 0 0 0 0 0 0 0 0 0 2 1 2 2 6 6 6 2 2 1 2 0 0 0 0
6 6 0 0 2 2 2 0 0 0 0 0 0 0 0 0 0 0 0 0 0 0 0 0 0 0 3 3 3 3 0 0 0 0 0 0 0 0 0 3 3 3 3 0 0 2 1 1 2 0 0 0 2 1 1 2 0 0 7 7
4 6 6 0 0 0 0 0 0 0 0 0 0 0 0 0 0 0 0 0 0 0 0 0 0 0 3 3 3 3 0 0 0 0 0 0 0 0 0 3 3 3 3 0 0 2 2 2 2 0 0 0 2 2 2 2 0 7 7 5
4 4 6 6 0 0 0 0 0 0 0 0 0 0 0 0 0 0 0 0 0 0 0 0 0 0 3 3 3 3 0 0 0 0 0 0 0 0 0 3 3 3 3 0 0 0 0 0 0 0 0 0 0 0 0 0 7 7 5 5
4 4 4 6 0 0 0 0 0 0 0 0 0 0 0 0 0 0 0 0 0 0 0 0 0 0 0 0 0 0 0 0 0 0 0 0 0 0 0 3 3 3 3 0 0 0 0 0 0 0 0 0 0 0 0 0 7 5 5 5
# BASES
2 1000 45 28 3 3
2 1001 4 56 3 3
# RADAR STATIONS
2 3000 13 44 2 2
2 3000 41 34 2 2
# ENERGY GEN
2 2000 2 37 2 2
2 2000 8 2 2 2
2 2000 7 16 2 2
2 2000 11 57 2 2
2 2000 15 30 2 2
2 2000 23 18 2 2
2 2000 32 56 2 2
2 2000 34 25 2 2
2 2000 37 9 2 2
2 2000 48 33 2 2
2 2000 53 11 2 2
2 2000 58 41 2 2
# MATERIAL GEN
2 2001 2 10 2 2
2 2001 6 23 2 2
2 2001 7 46 2 2
2 2001 18 9 2 2
2 2001 24 27 2 2
2 2001 28 13 2 2
2 2001 32 36 2 2
2 2001 18 50 2 2
2 2001 43 19 2 2
2 2001 46 57 2 2
2 2001 57 28 2 2
# UNITS
2 5200 38 40 1 1
2 5200 50 40 1 1
2 5200 45 44 1 1
## MOUNTAINS
2 4003 11 0 1 1
2 4007 12 0 1 1
2 4008 13 0 1 1
2 4010 14 0 1 1
2 4004 14 1 1 1
2 4005 14 2 1 1
2 4001 14 3 1 1
2 4000 10 5 1 1
2 4006 10 6 1 1
2 4013 10 7 1 1
2 4007 11 7 1 1
2 4002 12 7 1 1
2 4000 8 5 1 1
2 4006 8 6 1 1
2 4011 8 7 1 1
2 4009 7 7 1 1
2 4003 6 7 1 1
2 4002 3 5 1 1
2 4009 2 5 1 1
2 4008 1 5 1 1
2 4012 0 5 1 1
2 4005 0 6 1 1
2 4006 0 7 1 1
2 4001 0 8 1 1
2 4000 19 11 1 1
2 4004 19 12 1 1
2 4005 19 13 1 1
2 4011 19 14 1 1
2 4007 18 14 1 1
2 4009 17 14 1 1
2 4003 16 14 1 1
2 4002 12 11 1 1
2 4008 11 11 1 1
2 4012 10 11 1 1
2 4005 10 12 1 1
2 4001 10 13 1 1
2 4003 6 11 1 1
2 4008 7 11 1 1
2 4010 8 11 1 1
2 4006 8 12 1 1
2 4001 8 13 1 1
2 4000 5 16 1 1
2 4004 5 17 1 1
2 4005 5 18 1 1
2 4013 5 19 1 1
2 4007 6 19 1 1
2 4008 7 19 1 1
2 4009 8 19 1 1
2 4007 9 19 1 1
2 4008 10 19 1 1
2 4002 11 19 1 1
# top central
2 4000 0 19 1 1
2 4006 0 20 1 1
2 4005 0 21 1 1
2 4001 0 22 1 1
# top-right horizontal 
2 4003 08 29 1 1
2 4007 09 29 1 1
2 4000 10 27 1 1
2 4004 10 28 1 1
2 4014 10 29 1 1
2 4006 10 30 1 1
2 4001 10 31 1 1
# central-left T
2 4003 17 20 1 1
2 4007 18 20 1 1
2 4008 19 20 1 1
2 4016 20 20 1 1
2 4009 21 20 1 1
2 4008 22 20 1 1
2 4002 23 20 1 1
2 4000 20 17 1 1
2 4004 20 18 1 1
2 4005 20 19 1 1
# central-right T
2 4003 17 24 1 1
2 4007 18 24 1 1
2 4008 19 24 1 1
2 4008 20 24 1 1
2 4017 21 24 1 1
2 4009 22 24 1 1
2 4008 23 24 1 1
2 4007 24 24 1 1
2 4002 25 24 1 1
2 4004 21 25 1 1
2 4005 21 26 1 1
2 4006 21 27 1 1
2 4001 21 28 1 1
# small vertical bottom-right
2 4003 26 28 1 1
2 4007 27 28 1 1
2 4002 28 28 1 1
# bottom central L
2 4000 31 25 1 1
2 4006 31 26 1 1
2 4004 31 27 1 1
2 4013 31 28 1 1
2 4007 32 28 1 1
2 4008 33 28 1 1
2 4002 34 28 1 1
# bottom right T
2 4000 24 33 1 1
2 4004 24 34 1 1
2 4003 22 35 1 1
2 4007 23 35 1 1
2 4016 24 35 1 1
2 4008 25 35 1 1
2 4002 26 35 1 1
# big L on bottom left
2 4003 24 7 1 1
2 4007 25 7 1 1
2 4009 26 7 1 1
2 4008 27 7 1 1
2 4009 28 7 1 1
2 4007 29 7 1 1
2 4010 30 7 1 1
2 4004 30 8 1 1
2 4005 30 9 1 1
2 4006 30 10 1 1
2 4004 30 11 1 1
2 4001 30 12 1 1
# small vertical central-bottom
2 4003 28 19 1 1
2 4002 29 19 1 1
# bottom left long vertical
2 4003 22 2 1 1
2 4009 23 2 1 1
2 4008 24 2 1 1
2 4007 25 2 1 1
2 4009 26 2 1 1
2 4009 27 2 1 1
2 4007 28 2 1 1
2 4008 29 2 1 1
2 4009 30 2 1 1
2 4008 31 2 1 1
2 4007 32 2 1 1
2 4010 33 2 1 1
2 4004 33 3 1 1
2 4013 33 4 1 1
2 4009 34 4 1 1
2 4007 35 4 1 1
2 4002 36 4 1 1
# central top-right
2 4003 13 35 1 1
2 4008 14 35 1 1
2 4007 15 35 1 1
2 4002 16 35 1 1
# top right small corner
2 4012 5 36 1 1
2 4001 5 37 1 1
2 4002 6 36 1 1
# center bottom horizontal
2 4000 38 14 1 1
2 4006 38 15 1 1
2 4005 38 16 1 1
2 4004 38 17 1 1
2 4006 38 18 1 1
2 4001 38 19 1 1
# bottom right small corner
2 4003 36 33 1 1
2 4011 37 33 1 1
2 4000 37 32 1 1
# small top-right
2 4003 0 45 1 1
2 4002 1 45 1 1
# vertical top
2 4003 7 40 1 1
2 4009 8 40 1 1
2 4007 9 40 1 1
2 4008 10 40 1 1
2 4007 11 40 1 1
2 4002 12 40 1 1
# inverted L top-right
2 4003 9 50 1 1
2 4008 10 50 1 1
2 4009 11 50 1 1
2 4011 12 50 1 1
2 4000 12 49 1 1
# big horizontal central-right
2 4003 22 44 1 1
2 4009 23 44 1 1
2 4010 24 44 1 1
2 4004 24 45 1 1
2 4005 24 46 1 1
2 4006 24 47 1 1
2 4013 24 48 1 1
2 4008 25 48 1 1
2 4010 26 48 1 1
2 4006 26 49 1 1
2 4005 26 50 1 1
2 4004 26 51 1 1
2 4006 26 52 1 1
2 4004 26 53 1 1
2 4005 26 54 1 1
2 4006 26 55 1 1
2 4001 26 56 1 1
# vertical central-right
2 4003 29 41 1 1
2 4009 30 41 1 1
2 4008 31 41 1 1
2 4007 32 41 1 1
2 4002 33 41 1 1
# cross right
2 4003 34 50 1 1
2 4007 35 50 1 1
2 4009 36 50 1 1
2 4008 37 50 1 1
2 4018 38 50 1 1
2 4008 39 50 1 1
2 4009 40 50 1 1
2 4007 41 50 1 1
2 4002 42 50 1 1
2 4000 38 47 1 1
2 4004 38 48 1 1
2 4005 38 49 1 1
2 4006 38 51 1 1
2 4005 38 52 1 1
2 4001 38 53 1 1
# upside-down L right
2 4000 42 39 1 1
2 4013 42 40 1 1
2 4007 43 40 1 1
2 4008 44 40 1 1
2 4009 45 40 1 1
2 4007 46 40 1 1
2 4002 47 40 1 1
# little horizontal central-bottom
2 4000 53 35 1 1
2 4004 53 36 1 1
2 4001 53 37 1 1
# 4 corners bottom-right
2 4012 50 46 1 1
2 4001 50 47 1 1
2 4002 51 46 1 1
2 4013 50 54 1 1
2 4000 50 53 1 1
2 4002 51 54 1 1
2 4010 56 46 1 1
2 4001 56 47 1 1
2 4003 55 46 1 1
2 4011 56 54 1 1
2 4000 56 53 1 1
2 4003 55 54 1 1
# down L bottom-left
2 4000 53 0 1 1
2 4004 53 1 1 1
2 4005 53 2 1 1
2 4006 53 3 1 1
2 4005 53 4 1 1
2 4013 53 5 1 1
2 4007 54 5 1 1
2 4002 55 5 1 1
# L bottom-left
2 4003 43 8 1 1
2 4007 44 8 1 1
2 4009 45 8 1 1
2 4008 46 8 1 1
2 4010 47 8 1 1
2 4004 47 9 1 1
2 4005 47 10 1 1
2 4001 47 11 1 1
# big S next to bottom base
2 4003 46 22 1 1
2 4011 47 22 1 1
2 4004 47 21 1 1
2 4005 47 20 1 1
2 4006 47 19 1 1
2 4012 47 18 1 1
2 4007 48 18 1 1
2 4007 49 18 1 1
2 4008 50 18 1 1
2 4008 51 18 1 1
2 4009 52 18 1 1
2 4002 53 18 1 1
# practice target
2 4019 54 25 1 1
2 4019 49 25 1 1
2 4019 49 20 1 1
2 4019 54 20 1 1
# practice target
2 4019 40 48 1 1
