80 80
5 5 5 7 2 1 1 2 3 3 3 3 0 0 0 0 0 0 0 0 0 0 0 0 0 0 0 0 0 0 0 0 0 0 0 3 3 3 3 0 0 0 0 0 2 1 1 1 1 2 0 0 0 0 0 0 0 0 0 0 0 0 0 0 0 0 0 0 0 0 0 0 0 0 0 0 0 2 1 1
5 5 7 7 2 1 1 2 3 3 3 3 0 0 0 0 0 0 0 0 0 0 0 0 0 0 0 0 0 0 0 0 0 0 0 3 3 3 3 0 0 0 0 0 2 1 1 1 1 2 0 0 0 0 0 0 0 0 0 0 0 0 0 0 0 0 0 0 0 0 0 0 0 0 0 0 0 2 1 1
5 7 7 0 2 1 1 2 3 3 3 3 0 0 0 0 0 0 0 0 0 0 0 0 0 0 0 0 0 0 0 0 0 0 0 3 3 3 3 0 0 0 0 0 2 2 2 2 2 2 0 0 0 0 0 0 0 0 0 0 0 0 0 0 0 0 0 0 0 0 0 0 0 0 0 0 0 2 1 1
7 7 0 0 2 1 1 2 3 3 3 3 0 0 0 0 2 2 2 2 2 2 0 0 0 0 0 0 0 0 0 0 0 0 0 3 3 3 3 0 0 0 0 0 0 0 0 0 0 0 0 0 0 0 0 0 0 0 0 0 0 2 2 2 2 0 0 0 0 0 0 0 0 0 0 0 0 2 1 1
0 0 0 0 2 2 2 2 0 0 0 0 0 0 0 0 2 1 1 1 1 3 3 3 3 0 0 2 2 2 2 0 0 0 0 0 0 0 0 0 0 0 0 0 0 0 0 0 0 0 0 0 0 0 0 0 0 0 0 0 0 2 1 1 2 0 0 0 0 0 0 0 0 0 0 0 0 2 1 1
0 0 0 0 0 0 0 0 0 0 0 0 0 0 3 3 3 1 1 1 1 3 3 3 3 0 0 2 1 1 2 0 0 0 0 0 0 0 0 0 0 0 0 0 0 0 0 0 0 0 0 0 0 0 0 0 0 0 0 0 0 2 1 1 2 0 0 0 0 0 0 0 0 0 0 0 0 2 1 1
3 3 3 3 0 0 0 0 0 0 0 0 0 0 3 3 3 3 2 1 1 3 3 3 3 0 0 2 1 1 2 0 0 0 2 2 2 2 2 2 2 2 0 0 0 0 0 0 0 0 0 0 0 0 0 0 0 0 0 0 0 2 1 1 2 0 0 0 0 0 0 0 0 0 0 0 0 2 1 1
3 3 3 3 0 0 2 2 2 2 0 0 0 0 3 3 3 3 2 1 1 3 3 3 3 0 0 2 1 1 2 0 0 0 2 1 1 1 1 1 1 2 0 0 0 0 0 0 0 0 0 0 0 0 0 0 0 0 0 0 0 2 1 1 2 0 0 0 0 0 0 0 0 0 0 0 0 2 1 1
3 3 3 3 0 0 2 1 1 2 0 0 0 0 3 3 3 3 2 1 1 2 0 0 0 0 0 2 1 1 2 0 0 0 2 1 1 1 1 1 1 2 0 0 0 0 0 0 0 2 2 2 2 0 0 0 0 0 0 0 0 3 3 3 3 0 0 0 0 0 0 0 0 0 0 0 0 2 1 1
3 3 3 3 0 0 2 1 1 2 0 0 0 0 0 0 0 0 2 1 1 2 0 0 0 0 0 2 1 1 2 0 0 0 2 2 2 2 2 1 1 2 0 0 0 0 0 0 0 2 1 1 2 0 0 0 0 0 0 0 0 3 3 3 3 0 0 0 0 0 0 0 0 0 0 0 0 2 1 1
2 2 2 0 0 0 2 1 1 2 0 0 0 0 0 0 0 0 2 1 1 2 0 0 0 0 0 2 1 1 2 0 0 0 0 0 0 0 2 1 1 2 0 0 0 0 0 2 2 2 1 1 2 0 0 0 0 0 0 0 0 3 3 3 3 0 0 0 0 0 0 0 0 0 0 0 0 2 1 1
1 1 2 0 0 0 2 1 1 2 0 0 0 0 0 0 0 0 2 1 1 2 0 0 0 0 0 2 2 2 2 0 0 0 0 0 0 0 2 1 1 2 0 0 0 0 0 2 1 1 1 1 2 0 0 0 0 0 0 0 0 0 0 0 0 0 0 0 0 0 0 0 0 0 0 0 0 2 1 1
1 1 2 0 0 0 2 1 1 2 0 0 0 0 0 0 0 0 2 2 2 2 0 0 0 0 0 0 0 0 0 0 0 0 0 0 0 0 2 1 1 2 0 0 0 0 0 2 1 1 1 1 2 0 0 0 0 0 0 0 0 0 0 0 0 0 0 0 0 0 0 0 0 0 0 0 0 3 3 3
1 1 2 0 0 0 2 1 1 2 0 0 0 0 0 0 0 0 0 0 0 0 0 0 0 0 0 0 3 3 3 3 0 0 0 0 0 0 2 1 1 2 0 0 0 0 0 2 2 2 2 2 2 0 0 0 0 0 0 0 0 0 0 0 0 0 0 0 0 0 0 0 0 0 0 0 0 3 3 3
1 1 2 2 2 0 2 2 2 2 0 0 2 2 2 2 0 0 0 0 0 0 0 0 0 0 0 0 3 3 3 3 0 0 0 0 0 0 2 1 1 2 0 0 0 0 0 0 0 0 0 0 0 0 0 0 0 0 0 0 2 2 2 2 2 2 2 2 2 2 0 0 0 0 0 0 0 3 3 3
1 1 1 1 2 0 0 0 0 0 0 0 2 1 1 2 0 0 0 0 0 0 0 0 0 0 0 0 3 3 3 3 0 0 0 0 0 0 2 2 2 2 0 0 0 0 0 0 0 0 0 0 0 0 0 0 0 0 0 0 2 1 1 1 1 1 1 1 1 2 0 0 0 0 0 0 0 0 0 0
1 1 1 1 2 0 0 0 0 0 0 0 2 1 1 2 0 0 0 0 0 0 0 0 0 0 0 0 3 3 3 3 0 0 0 0 0 0 0 0 0 0 0 0 0 0 0 0 3 3 3 3 0 0 0 0 0 0 0 0 2 1 1 1 1 1 1 1 1 2 0 0 0 0 0 0 0 0 0 0
2 2 2 2 2 0 0 0 0 0 0 0 2 1 1 2 0 0 0 0 0 0 0 0 0 0 0 0 0 0 0 0 0 0 0 0 0 0 0 0 0 0 0 0 0 0 0 0 3 3 3 3 0 0 0 0 0 0 0 0 2 2 6 4 4 1 1 2 2 2 0 0 0 0 0 0 0 0 0 0
0 0 0 0 0 0 0 0 0 0 0 0 2 1 1 2 2 2 2 2 2 2 2 2 2 2 0 0 0 0 0 0 0 0 0 0 0 0 0 0 0 0 0 0 0 0 0 0 3 3 3 3 0 0 0 0 0 0 0 0 0 0 6 6 4 1 1 2 0 0 0 0 0 0 0 0 0 0 0 0
0 0 0 0 0 0 0 0 0 0 0 0 2 1 1 1 1 1 1 1 1 1 1 1 1 2 0 0 0 0 0 0 0 0 0 0 0 0 0 0 0 0 0 0 0 0 0 0 3 3 3 3 0 0 0 0 0 0 0 0 0 0 0 6 6 1 1 2 0 0 0 0 0 0 0 0 0 0 0 0
2 2 2 2 0 0 0 0 0 0 0 0 2 1 1 1 1 1 1 1 1 1 1 1 1 2 0 0 0 0 0 0 0 0 0 0 0 0 0 0 0 0 0 2 2 2 2 0 0 0 0 0 0 0 0 0 0 0 0 0 0 0 0 0 2 1 1 2 0 0 0 0 0 0 0 0 0 0 0 0
2 1 1 2 0 0 0 0 0 0 0 0 2 2 2 2 3 3 3 3 2 2 2 1 1 2 0 0 0 0 0 0 0 0 2 2 2 2 0 0 0 0 0 2 1 1 2 0 0 0 0 0 0 0 0 0 0 0 0 0 0 0 0 0 2 2 2 2 0 0 0 0 0 0 0 0 0 0 0 0
2 1 1 2 0 0 2 2 2 2 0 0 0 0 0 0 3 3 3 3 0 0 2 1 1 2 0 0 0 0 0 0 0 0 2 1 1 2 0 0 0 0 0 2 1 1 2 2 2 2 2 0 0 0 0 0 0 0 0 0 0 0 0 0 0 0 0 0 0 0 0 0 2 2 2 2 2 2 0 0
2 1 1 2 0 7 7 1 1 2 0 0 0 0 0 0 3 3 3 3 0 0 2 1 1 2 0 0 0 0 0 0 0 0 2 1 1 2 0 0 0 0 0 2 1 1 1 1 1 1 2 0 0 0 0 0 0 0 0 0 0 0 0 0 0 0 0 0 0 0 0 0 2 1 1 1 1 2 0 0
2 1 1 2 0 7 5 1 1 2 0 0 0 0 0 0 3 3 3 3 0 0 2 1 1 2 0 0 0 0 0 0 0 0 2 1 1 2 0 0 0 0 0 2 1 1 1 1 1 1 2 2 2 0 0 0 0 2 2 2 2 2 2 2 2 0 0 0 0 0 0 0 2 1 1 1 1 7 7 0
2 1 1 2 0 7 5 1 1 2 0 0 0 0 0 0 0 0 0 0 0 0 2 2 2 2 0 0 0 0 0 0 0 0 2 1 1 2 0 0 0 0 0 2 2 2 2 2 1 1 1 1 2 0 0 0 0 2 1 1 1 1 1 1 2 0 0 0 0 0 0 0 2 1 1 5 5 5 7 0
2 1 1 2 0 7 5 1 1 2 0 0 0 0 0 0 0 0 0 0 0 0 0 0 0 0 0 0 0 0 0 0 0 0 2 1 1 2 0 0 0 0 0 0 0 0 0 2 1 1 1 1 2 0 0 0 0 2 1 1 1 1 1 1 2 0 0 0 0 0 0 0 2 1 1 5 7 7 7 0
2 1 1 2 0 7 5 1 1 2 0 0 0 0 0 0 0 0 0 0 0 0 0 0 0 0 0 2 2 2 2 0 0 0 2 1 1 2 0 0 0 0 0 0 0 0 0 2 2 2 2 2 2 0 0 0 0 2 2 2 2 2 1 1 2 0 0 0 2 2 2 2 2 1 1 5 7 0 0 0
2 1 1 2 0 7 5 1 1 2 0 0 0 0 0 0 0 0 0 0 0 0 0 0 0 0 0 2 1 1 2 0 0 0 2 2 2 2 0 0 0 0 0 0 0 0 0 0 0 0 0 0 0 0 0 0 0 0 0 0 0 2 1 1 2 0 0 0 2 1 1 1 1 1 1 7 7 0 0 0
2 1 1 2 0 7 5 1 1 2 0 0 0 0 0 0 0 0 0 0 0 0 0 2 2 2 2 2 1 1 2 0 0 0 0 0 0 0 0 0 0 0 0 0 0 0 0 0 0 0 0 0 0 0 0 0 0 0 0 0 0 2 2 2 2 0 0 0 2 1 1 1 1 1 1 2 0 0 0 0
2 1 1 2 0 7 7 1 1 2 0 0 0 0 0 0 0 0 0 0 0 0 0 2 1 1 1 1 1 1 2 0 0 0 3 3 3 3 0 0 0 0 0 0 0 0 0 0 0 0 0 0 0 0 3 3 3 3 0 0 0 0 0 0 0 0 0 0 2 2 2 2 2 1 1 2 0 0 0 0
2 1 1 2 0 0 2 2 2 2 0 0 0 0 0 0 0 0 0 0 0 0 0 2 1 1 1 1 1 1 2 0 0 0 3 3 3 3 0 0 0 0 0 0 0 0 0 0 0 0 0 0 0 0 3 3 3 3 0 0 0 0 0 0 0 0 0 0 0 0 0 0 2 1 1 2 0 0 0 0
2 1 1 2 2 2 0 0 0 0 0 0 0 0 0 0 0 0 0 0 0 0 0 3 3 3 3 2 1 1 2 0 0 0 3 3 3 3 0 0 0 0 0 0 0 0 0 0 0 0 0 0 0 0 3 3 3 3 0 0 0 0 0 0 0 0 0 0 0 0 0 0 2 1 1 2 0 0 0 0
2 1 1 1 1 2 0 0 0 0 0 0 0 0 0 0 0 0 0 0 0 0 0 3 3 3 3 2 1 1 6 6 0 0 3 3 3 3 0 0 0 0 0 0 0 0 0 0 0 2 2 2 2 0 3 3 3 3 0 0 0 0 0 0 0 0 0 0 0 0 0 0 2 1 1 2 0 0 0 0
2 1 1 1 1 2 0 0 0 0 0 0 0 0 0 0 0 0 0 0 0 0 0 3 3 3 3 2 1 1 4 6 6 0 0 0 0 0 0 0 0 0 0 0 0 0 0 0 0 2 1 1 2 0 0 0 0 0 0 0 0 0 0 0 0 0 0 0 0 0 0 0 2 1 1 2 0 0 0 0
2 2 2 2 2 2 0 3 3 3 3 0 0 0 0 0 0 0 0 0 0 0 0 3 3 3 3 2 1 1 4 4 6 2 2 2 2 0 0 0 0 0 0 0 0 0 0 0 7 7 1 1 2 0 0 0 0 0 0 0 0 0 0 0 0 0 0 0 0 0 0 0 2 1 1 2 0 0 0 0
0 0 0 0 0 0 0 3 3 3 3 0 0 2 2 2 2 2 2 2 2 0 0 0 0 0 0 2 1 1 1 1 1 1 1 1 2 0 0 0 0 0 0 0 0 0 0 7 7 5 1 1 2 0 0 0 0 0 0 0 0 0 0 0 0 0 0 0 0 0 0 0 2 1 1 2 0 0 0 0
0 0 0 0 0 0 0 3 3 3 3 0 0 2 1 1 1 1 1 1 2 0 0 0 0 0 0 2 1 1 1 1 1 1 1 1 2 0 0 0 0 0 0 0 0 2 2 7 5 5 1 1 2 2 2 2 2 0 0 0 0 0 0 0 0 0 0 0 0 0 0 0 2 1 1 2 0 0 0 0
0 0 0 0 0 0 0 3 3 3 3 0 0 2 1 1 1 1 1 1 2 0 0 0 0 0 0 2 2 2 2 2 2 2 2 2 2 0 0 0 0 0 0 0 0 2 1 1 1 1 1 1 1 1 1 1 2 0 0 0 0 0 0 0 0 0 0 0 0 0 0 0 2 1 1 2 0 0 0 0
0 0 0 0 0 0 0 0 0 0 0 0 0 2 2 2 2 2 2 2 2 0 0 0 0 0 0 0 0 0 0 0 0 0 0 0 0 0 0 0 0 0 0 0 0 2 1 1 1 1 1 1 1 1 1 1 2 0 0 0 0 0 0 0 0 0 0 0 0 0 0 0 2 1 1 2 0 0 0 0
0 0 0 0 0 0 0 2 2 2 2 0 0 0 0 0 0 0 0 0 0 0 0 0 0 0 0 0 0 0 0 0 0 0 0 0 0 0 0 0 0 0 0 0 0 2 2 2 2 2 1 1 2 2 2 2 2 0 0 0 0 0 0 0 2 2 2 2 2 2 2 2 2 1 1 2 0 0 0 0
0 0 0 0 0 0 0 2 1 1 2 0 0 0 0 0 0 3 3 3 3 0 0 0 0 0 0 0 0 0 0 0 0 0 0 0 0 0 2 2 2 2 0 0 0 0 0 0 0 2 1 1 2 0 0 0 0 0 0 0 0 0 0 0 2 1 1 1 1 1 1 1 1 1 1 2 0 0 0 0
0 0 0 0 0 7 7 7 1 1 2 0 0 0 0 0 0 3 3 3 3 0 0 0 0 0 0 0 0 0 0 0 0 0 0 0 0 0 2 1 1 2 0 0 0 0 0 0 0 2 1 1 2 0 0 0 0 0 0 0 0 0 0 0 2 1 1 1 1 1 1 1 1 1 1 2 0 0 0 0
0 0 0 0 0 7 5 5 1 1 2 0 0 0 0 0 0 3 3 3 3 0 0 0 0 0 0 0 0 0 0 0 0 0 0 0 0 0 2 1 1 2 0 0 0 0 0 0 0 2 1 1 2 0 0 0 0 0 0 0 0 0 0 0 2 1 1 2 2 2 2 2 2 2 2 2 0 0 0 0
0 0 0 0 0 7 5 5 1 1 2 0 0 0 0 0 0 3 3 3 3 0 0 0 0 0 0 0 0 0 0 0 0 0 0 0 0 0 2 1 1 2 0 0 0 0 0 0 0 2 1 1 2 0 0 3 3 3 3 0 0 0 0 0 2 1 1 2 0 0 0 0 0 0 0 0 0 3 3 3
0 0 0 0 0 7 5 5 1 1 2 0 0 0 0 0 0 0 0 0 0 2 2 2 2 0 0 0 0 0 0 0 0 0 0 0 0 0 2 1 1 2 0 0 0 0 0 0 0 2 1 1 2 0 0 3 3 3 3 0 0 0 0 0 2 1 1 2 0 0 0 0 0 0 0 0 0 3 3 3
0 0 0 0 0 7 5 5 1 1 2 2 2 0 0 0 0 0 0 0 0 2 1 1 2 0 0 0 0 0 0 0 0 0 0 0 0 0 2 1 1 2 0 0 0 0 0 0 0 2 1 1 2 0 0 3 3 3 3 0 0 0 0 0 2 1 1 2 0 0 0 0 0 0 0 0 0 3 3 3
0 0 0 0 0 7 5 5 1 1 1 1 2 0 0 0 0 2 2 2 2 2 1 1 2 0 0 0 0 0 0 0 0 0 0 0 0 0 2 1 1 2 0 0 0 0 0 0 0 2 1 1 2 0 0 3 3 3 3 0 0 0 0 0 2 2 2 2 0 0 0 0 0 0 0 0 0 3 3 3
0 0 0 0 0 7 7 7 1 1 1 1 2 0 0 0 0 2 1 1 1 1 1 1 2 0 0 0 0 0 0 0 0 0 0 0 0 0 2 2 2 2 0 0 0 0 0 0 0 2 1 1 2 0 0 0 0 0 0 0 0 0 0 0 0 0 0 0 0 0 0 0 0 0 0 0 0 0 0 0
0 0 0 0 0 0 0 2 2 2 2 2 2 0 0 0 0 2 1 1 1 1 1 1 2 0 0 0 0 0 0 0 0 0 0 0 0 0 0 0 0 0 0 0 0 0 0 0 0 2 1 1 2 0 0 0 0 0 0 0 0 0 0 0 0 0 0 0 0 0 0 0 0 0 0 0 0 0 0 0
0 0 0 0 0 0 0 0 0 0 0 0 0 0 0 0 0 2 1 1 2 2 2 2 2 0 0 0 0 0 0 0 2 2 2 2 2 2 0 0 0 0 0 0 0 0 0 0 0 2 1 1 2 0 0 0 0 0 0 0 0 0 0 0 0 0 0 0 0 0 0 0 0 0 0 0 0 0 0 0
0 0 0 0 0 0 0 0 0 0 0 0 0 0 0 0 0 2 1 1 2 0 0 0 0 0 0 0 0 0 0 0 2 1 1 1 1 2 0 0 0 0 0 0 0 0 0 0 0 2 1 1 2 2 2 2 2 2 2 0 0 0 0 0 0 0 0 0 0 0 0 0 0 0 0 0 0 0 0 0
2 2 2 2 2 2 2 2 2 3 3 3 3 0 0 0 0 2 1 1 2 0 0 0 0 0 0 0 0 0 0 0 2 1 1 1 1 2 3 3 3 3 0 0 0 0 0 0 0 2 1 1 1 1 1 1 1 1 2 0 0 0 0 0 0 0 0 0 0 0 0 0 0 0 0 0 0 0 0 0
1 1 1 1 1 1 1 1 2 3 3 3 3 0 0 0 0 2 1 1 2 0 0 0 0 0 0 0 0 0 0 0 2 1 1 1 1 2 3 3 3 3 0 0 0 0 0 0 0 2 1 1 1 1 1 1 1 1 2 0 0 0 2 2 2 2 2 2 2 2 2 2 2 2 0 0 0 0 0 0
1 1 1 1 1 1 1 1 2 3 3 3 3 0 0 0 0 2 1 1 2 0 0 0 0 0 0 0 0 0 0 0 2 1 1 1 1 2 3 3 3 3 0 0 0 0 0 0 0 2 2 2 2 2 2 2 1 1 2 0 0 0 2 1 1 1 1 2 2 1 1 1 1 2 0 0 0 0 0 0
2 2 2 6 4 4 1 1 2 3 3 3 3 0 0 0 0 2 1 1 2 0 0 0 0 0 3 3 3 3 0 0 2 2 2 2 2 2 3 3 3 3 0 0 0 0 0 0 0 0 0 0 0 0 0 2 1 1 2 0 0 0 2 1 1 1 1 2 2 1 1 1 1 2 0 0 0 0 0 0
0 0 0 6 6 4 1 1 2 0 0 0 0 0 0 0 0 2 2 2 2 0 0 0 0 0 3 3 3 3 0 0 0 0 0 0 0 0 0 0 0 0 0 0 0 0 0 0 0 0 0 0 0 0 0 2 2 2 2 0 0 0 2 1 1 2 6 6 6 6 2 1 1 2 0 0 0 0 0 0
0 0 0 0 6 6 1 1 2 0 0 0 0 0 0 0 0 0 0 0 0 0 0 0 0 0 3 3 3 3 0 0 0 0 0 0 0 0 0 0 0 0 0 0 0 0 0 0 0 0 0 0 0 0 0 0 0 0 0 0 0 0 2 1 1 6 6 4 4 6 6 1 1 2 0 0 0 0 0 0
0 0 0 0 0 2 1 1 2 0 0 0 0 0 0 0 0 0 0 0 0 0 0 0 0 0 3 3 3 3 0 0 0 0 0 0 0 0 0 0 0 0 0 0 0 0 0 0 0 0 0 0 0 0 0 0 0 0 0 0 0 0 2 2 2 6 4 4 4 4 6 2 2 2 0 0 0 0 0 0
0 0 0 0 0 2 1 1 2 0 0 0 0 0 0 0 0 0 0 0 0 0 0 0 0 0 0 0 0 0 0 0 0 0 0 0 0 0 0 0 0 0 0 0 0 0 0 0 0 0 0 0 0 0 0 0 0 0 0 0 0 0 2 2 2 6 4 4 4 4 6 2 2 2 0 0 0 0 0 0
0 0 0 0 0 2 1 1 2 0 0 0 0 0 0 0 0 0 0 0 0 0 0 0 0 0 0 0 0 0 0 0 0 0 0 0 0 0 0 0 0 0 0 0 0 0 0 0 0 0 0 0 0 0 0 0 0 0 0 0 0 0 2 1 1 6 6 4 4 6 6 1 1 2 0 0 0 0 0 0
0 0 0 0 0 2 2 2 2 0 0 0 0 0 0 0 0 0 0 0 0 0 0 0 0 0 2 2 2 2 2 2 2 2 2 2 2 2 2 2 2 2 2 2 0 0 0 0 0 0 0 0 0 0 0 0 0 0 0 0 0 0 2 1 1 2 6 6 6 6 2 1 1 2 0 0 0 0 0 0
0 0 0 0 0 0 0 0 0 0 0 0 0 0 0 0 0 0 0 0 0 0 0 0 0 0 2 1 1 1 1 1 1 1 1 1 1 1 1 1 1 1 1 2 0 0 0 0 0 0 0 0 0 0 0 0 0 0 0 0 0 0 2 1 1 1 1 2 2 1 1 1 1 2 0 0 0 0 0 0
0 0 0 0 0 0 0 0 0 0 0 0 0 0 0 0 0 0 0 0 0 0 0 0 0 0 2 1 1 1 1 1 1 1 1 1 1 1 1 1 1 1 1 2 0 0 0 0 0 0 0 0 0 0 0 0 0 0 0 0 0 0 2 1 1 1 1 2 2 1 1 1 1 2 0 0 0 0 0 0
0 0 0 0 0 0 0 0 0 0 0 0 0 0 0 0 0 0 0 0 0 0 0 0 0 0 2 2 2 2 2 1 1 2 2 2 2 2 2 2 2 1 1 2 0 0 0 0 0 0 0 0 0 0 0 0 0 0 0 0 0 0 2 2 2 2 2 2 2 2 2 2 2 2 0 0 0 0 0 0
0 0 0 0 0 0 0 0 0 0 0 0 0 0 0 0 0 0 0 0 0 0 0 0 0 0 0 0 0 0 2 1 1 2 0 0 0 0 0 0 2 1 1 2 2 2 2 2 2 2 2 2 0 0 0 0 2 2 2 2 0 0 0 0 0 0 0 0 0 0 0 0 0 0 0 0 0 0 0 0
0 0 0 0 0 0 0 0 0 0 0 0 0 0 0 0 0 0 0 0 0 0 0 0 0 0 0 0 0 0 2 1 1 2 0 0 0 0 0 0 2 1 1 1 1 1 1 1 1 1 1 2 0 0 0 0 2 1 1 2 0 0 0 0 0 0 0 0 0 0 0 3 3 3 3 0 0 0 0 0
0 0 0 0 0 0 0 0 0 0 0 0 0 0 0 0 0 0 0 0 0 0 0 0 0 0 0 0 0 0 2 1 1 2 0 0 0 0 0 0 2 1 1 1 1 1 1 1 1 1 1 2 0 0 0 0 2 1 1 2 0 0 0 0 0 0 0 0 0 0 0 3 3 3 3 0 0 0 0 0
0 0 0 0 0 0 0 0 0 0 0 0 0 0 0 0 0 0 0 0 0 0 0 0 0 0 0 0 0 0 2 1 1 2 0 0 0 0 0 0 2 1 1 5 5 7 2 2 2 2 2 2 0 0 0 0 2 1 1 2 0 0 0 0 0 0 0 0 0 0 0 3 3 3 3 0 0 0 0 0
0 0 0 0 0 0 0 0 0 0 0 0 0 0 0 0 0 0 0 0 0 0 0 0 0 0 0 0 0 0 2 1 1 2 0 0 0 0 0 0 2 1 1 5 7 7 0 0 0 0 0 3 3 3 3 0 2 1 1 2 0 0 0 0 0 0 0 0 0 0 0 3 3 3 3 0 0 0 0 0
0 0 0 0 0 0 0 0 0 0 0 0 0 0 0 0 0 0 0 0 0 0 0 0 0 0 0 0 0 0 2 2 2 2 0 0 0 0 0 0 2 1 1 7 7 0 0 0 0 0 0 3 3 3 3 0 2 1 1 2 0 0 0 0 0 0 0 0 0 0 0 0 0 0 0 0 0 0 0 0
0 0 0 0 2 2 2 2 2 2 2 2 2 2 2 2 2 2 0 0 0 0 0 0 0 0 0 0 0 0 0 0 0 0 0 0 0 0 2 2 2 1 1 2 0 0 0 0 0 0 0 3 3 3 3 0 2 1 1 2 0 0 0 0 0 0 2 2 2 2 2 2 2 2 2 2 0 0 0 0
0 0 0 0 2 1 1 1 1 1 1 1 1 1 1 1 1 2 0 0 0 0 0 0 0 0 0 0 0 0 0 0 0 0 0 0 0 0 2 1 1 1 1 2 0 0 0 0 0 0 0 3 3 3 3 0 2 1 1 2 0 0 0 0 0 0 2 1 1 1 1 1 1 1 1 2 0 0 0 0
0 0 0 0 2 1 1 1 1 1 1 1 1 1 1 1 1 2 2 2 2 2 2 2 2 2 3 3 3 3 0 0 0 0 0 0 0 0 2 1 1 1 1 2 0 0 0 0 0 0 2 2 2 2 2 2 2 1 1 2 0 0 0 0 0 0 2 1 1 1 1 1 1 1 1 2 0 0 0 0
0 0 0 0 2 2 2 2 2 2 2 2 2 2 2 1 1 1 1 1 1 1 1 1 1 2 3 3 3 3 0 0 0 0 0 0 0 0 2 2 2 2 2 2 0 0 0 0 0 0 2 1 1 1 1 1 1 1 1 2 0 0 0 0 0 0 2 1 1 2 2 2 2 2 2 2 0 0 0 0
0 0 0 0 0 0 0 0 0 0 0 0 0 0 2 1 1 1 1 1 1 1 1 1 1 2 3 3 3 3 0 0 0 0 0 0 0 0 0 0 0 0 0 0 0 0 0 0 0 0 2 1 1 1 1 1 1 1 1 2 2 2 2 2 2 2 2 1 1 2 0 0 0 0 0 0 0 0 0 0
3 3 3 3 0 0 0 0 0 0 0 0 0 0 2 2 2 2 2 2 2 2 2 2 2 2 3 3 3 3 0 0 0 0 0 0 0 0 0 0 0 0 0 0 0 0 0 0 0 0 2 2 2 2 2 2 2 1 1 1 1 1 1 1 1 1 1 1 1 2 0 0 0 0 0 0 0 0 7 7
3 3 3 3 0 0 0 0 0 0 0 0 0 0 0 0 0 0 0 0 0 0 0 0 0 0 0 0 0 0 0 0 0 0 0 0 0 0 0 0 0 0 0 0 0 0 0 0 0 0 0 0 0 0 0 0 2 1 1 1 1 1 1 1 1 1 1 1 1 2 0 0 0 0 0 0 0 7 7 5
3 3 3 3 0 0 0 0 0 0 0 0 0 0 0 0 0 0 0 0 0 0 0 0 0 0 0 0 0 0 0 0 0 0 0 0 0 0 0 0 0 0 0 0 0 0 0 0 0 0 0 0 0 0 0 0 2 2 2 2 2 2 2 2 2 2 2 2 2 2 0 0 0 0 0 0 7 7 5 5
3 3 3 3 0 0 0 0 0 0 0 0 0 0 0 0 0 0 0 0 0 0 0 0 0 0 0 0 0 0 0 0 0 0 0 0 0 0 0 0 0 0 0 0 0 0 0 0 0 0 0 0 0 0 0 0 0 0 0 0 0 0 0 0 0 0 0 0 0 0 0 0 0 0 0 0 7 5 5 5
# BASES
2 1000 65 15 3 3
2 1001 6 75 3 3
# ENERGY GEN
2 2000 2 37 2 2
2 2000 8 2 2 2
2 2000 7 16 2 2
2 2000 9 63 2 2
2 2000 15 30 2 2
2 2000 32 56 2 2
2 2000 34 25 2 2
2 2000 37 9 2 2
2 2000 46 79 2 2
2 2000 54 11 2 2
2 2000 54 40 2 2
2 2000 68 73 2 2
2 2000 75 28 2 2
# MATERIAL GEN
2 2001 2 10 2 2
2 2001 6 23 2 2
2 2001 13 79 2 2
2 2001 23 18 2 2
2 2001 32 36 2 2
2 2001 18 50 2 2
2 2001 43 19 2 2
2 2001 46 57 2 2
2 2001 57 28 2 2
2 2001 71 53 2 2
2 2001 78 2 2 2
# UNITS
2 5200 38 40 1 1
2 5200 50 40 1 1
2 5200 45 44 1 1
## MOUNTAINS
2 4020 73 6 2 2
2 4030 73 8 2 2
2 4025 73 10 2 2
2 4024 73 12 2 2
2 4026 73 14 2 2
2 4027 73 16 2 2
2 4028 75 16 2 2
2 4029 75 18 2 2
2 4030 75 20 2 2
2 4031 75 22 2 2
2 4023 75 24 2 2
# mountains 2
2 4022 69 32 2 2
2 4030 67 32 2 2
2 4029 65 32 2 2
2 4028 63 32 2 2
2 4031 63 34 2 2
2 4025 63 36 2 2
2 4030 63 38 2 2
2 4026 63 40 2 2
2 4029 63 42 2 2
2 4028 65 42 2 2
2 4031 67 42 2 2
2 4025 67 44 2 2
2 4027 67 46 2 2
2 4030 67 48 2 2
2 4023 67 50 2 2
2 4031 69 42 2 2
2 4024 71 42 2 2
2 4029 73 42 2 2
2 4020 73 40 2 2
2 4024 63 30 2 2
2 4020 63 28 2 2
# mountains 3
2 4020 75 52 2 2
2 4024 75 54 2 2
2 4030 75 56 2 2
2 4021 67 58 2 2
2 4026 69 58 2 2
2 4031 71 58 2 2
2 4025 73 58 2 2
2 4029 75 58 2 2
2 4027 77 58 2 2
2 4024 77 60 2 2
2 4029 77 62 2 2
2 4026 77 64 2 2
2 4031 77 66 2 2
2 4030 77 68 2 2
2 4025 75 68 2 2
2 4029 73 68 2 2
2 4027 73 70 2 2
2 4024 73 72 2 2
2 4023 73 74 2 2
# mountains 4
2 4022 60 7 2 2
2 4025 58 7 2 2
2 4031 56 7 2 2
2 4027 54 7 2 2
2 4024 54 5 2 2
2 4030 54 3 2 2
2 4028 54 1 2 2
# mountains 5
2 4022 55 19 2 2
2 4027 53 19 2 2
2 4031 51 19 2 2
2 4026 49 19 2 2
2 4030 49 21 2 2
2 4024 49 23 2 2
2 4021 47 23 2 2
# mountains 6
2 4023 48 11 2 2
2 4030 48 9 2 2
2 4024 46 9 2 2
2 4029 44 9 2 2
2 4021 42 9 2 2
# mountains 7
2 4022 30 8 2 2
2 4030 28 8 2 2
2 4025 26 8 2 2
2 4021 24 8 2 2
# mountains 8
2 4023 34 4 2 2
2 4026 34 2 2 2
2 4031 32 2 2 2
2 4025 30 2 2 2
2 4027 28 2 2 2
2 4030 26 2 2 2
2 4029 24 2 2 2
2 4021 22 2 2 2
# mountains 9
2 4024 52 36 2 2
2 4025 52 34 2 2
2 4030 54 36 2 2
2 4031 54 34 2 2
# mountains 10
2 4022 47 40 2 2
2 4025 45 40 2 2
2 4021 43 40 2 2
# mountains 11
2 4021 29 29 2 2
2 4031 31 29 2 2
2 4024 31 27 2 2
2 4020 31 25 2 2
2 4024 33 29 2 2
2 4029 35 29 2 2
2 4025 37 29 2 2
2 4030 37 31 2 2
2 4031 37 33 2 2
2 4023 37 35 2 2
# mountains 12
2 4021 35 51 2 2
2 4030 37 51 2 2
2 4031 39 51 2 2
2 4026 39 49 2 2
2 4020 39 47 2 2
2 4027 39 53 2 2
2 4023 39 55 2 2
2 4025 41 51 2 2
2 4031 43 51 2 2
2 4026 45 51 2 2
2 4030 47 51 2 2
2 4024 49 51 2 2
2 4026 51 51 2 2
2 4031 53 51 2 2
2 4029 53 53 2 2
2 4025 53 55 2 2
2 4027 53 57 2 2
2 4022 55 57 2 2
# mountains 13
2 4023 38 15 2 2
2 4029 38 17 2 2
2 4023 38 19 2 2
# mountains 14
2 4023 63 66 2 2
2 4025 63 64 2 2
2 4021 61 64 2 2
2 4022 57 64 2 2
2 4026 55 64 2 2
2 4023 55 66 2 2
2 4020 55 70 2 2
2 4030 55 72 2 2
2 4022 57 72 2 2
2 4021 61 72 2 2
2 4029 63 72 2 2
2 4020 63 70 2 2
# mountains 15
2 4022 46 66 2 2
2 4025 44 66 2 2
2 4028 42 66 2 2
2 4031 42 68 2 2
2 4024 42 70 2 2
2 4027 42 72 2 2
2 4030 42 74 2 2
2 4025 40 74 2 2
2 4026 38 74 2 2
2 4031 36 74 2 2
2 4028 34 74 2 2
2 4029 32 74 2 2
2 4024 30 74 2 2
2 4030 28 74 2 2
2 4027 26 74 2 2
2 4025 24 74 2 2
2 4023 24 76 2 2
2 4031 29 72 2 2
2 4020 29 70 2 2
# mountains 16
2 4020 26 59 2 2
2 4030 26 61 2 2
2 4027 26 63 2 2
2 4022 28 63 2 2
# mountains 17
2 4022 20 66 2 2
2 4026 18 66 2 2
2 4024 16 66 2 2
2 4023 16 68 2 2
2 4031 16 64 2 2
2 4020 16 62 2 2
# mountains 18
2 4022 7 63 2 2
2 4021 5 63 2 2
# mountains 19
2 4022 11 79 2 2
2 4031 9 79 2 2
2 4028 7 79 2 2
2 4026 5 79 2 2
2 4030 3 79 2 2
2 4025 1 79 2 2
# mountains 20
2 4020 1 46 2 2
2 4023 1 48 2 2
# mountains 21
2 4020 12 49 2 2
2 4026 12 51 2 2
2 4022 10 51 2 2
# mountains 22
2 4022 27 36 2 2
2 4028 25 36 2 2
2 4021 23 36 2 2
# mountains 23
2 4023 26 51 2 2
2 4026 26 49 2 2
2 4028 24 49 2 2
2 4029 24 47 2 2
2 4030 24 45 2 2
2 4021 22 45 2 2
# mountains 24
2 4022 13 8 2 2
2 4029 11 8 2 2
2 4021 9 8 2 2
# mountains 24
2 4022 3 6 2 2
2 4021 1 6 2 2
# mountains 25
2 4023 16 3 2 2
2 4029 16 1 2 2
2 4025 14 1 2 2
2 4021 12 1 2 2
# mountains 26
2 4022 11 20 2 2
2 4029 9 20 2 2
2 4024 7 20 2 2
2 4026 5 20 2 2
2 4020 5 18 2 2
# mountains 27
2 4022 10 29 2 2
2 4031 8 29 2 2
2 4021 6 29 2 2
# mountains 28
2 4021 16 14 2 2
2 4031 18 14 2 2
2 4027 20 14 2 2
2 4024 20 16 2 2
2 4026 20 18 2 2
2 4030 20 20 2 2
2 4029 20 22 2 2
2 4025 20 24 2 2
2 4027 22 24 2 2
2 4022 24 24 2 2
# mountains 28
2 4022 14 40 2 2
2 4031 14 40 2 2
2 4024 12 40 2 2
2 4029 10 40 2 2
2 4027 8 40 2 2
2 4031 8 38 2 2
2 4020 8 36 2 2
