00111100
00000000
11100111
10000001
10000001
11100111
00000000
00111100
