000000000
010000010
001000100
000101000
000010000
000101000
001000100
010000010
000000000
